Piscium Sector KT-Q a5-2	T (Brown dwarf) Star
Pegasi Sector PD-P a7-2	Y (Brown dwarf) Star
Latuca	M (Red dwarf) Star
Garoku	M (Red dwarf) Star
Arietis Sector ZF-O b6-4	M (Red giant) Star
Pegasi Sector NS-Q a6-5	Y (Brown dwarf) Star
Pegasi Sector JM-S a5-3	T Tauri Star
HIP 1294	K (Yellow-Orange) Star
Hyades Sector YB-K b9-0	M (Red dwarf) Star
Col 285 Sector AH-A b15-5	T Tauri Star
Cephei Sector KM-W c1-24	M (Red dwarf) Star
Marmatae	M (Red dwarf) Star
Darudnikepa	K (Yellow-Orange) Star
Acants	K (Yellow-Orange) Star
Cempsigi	M (Red dwarf) Star
Piscium Sector KN-T b3-7	M (Red dwarf) Star
Arietis Sector LP-D a13-2	L (Brown dwarf) Star
Bomazi	M (Red dwarf) Star
NLTT 52560	M (Red dwarf) Star
Kuri Hsing	M (Red dwarf) Star
HIP 3428	M (Red dwarf) Star
Pegasi Sector LX-Q a6-3	T (Brown dwarf) Star
Hyades Sector CI-I b10-2	M (Red dwarf) Star
HR 529	F (White) Star
Pegasi Sector VO-Q b5-3	M (Red dwarf) Star
Piscium Sector GN-S a4-4	T (Brown dwarf) Star
Arietis Sector LP-D a13-3	Y (Brown dwarf) Star
HR 409	F (White) Star
Pegasi Sector HB-W b2-2	M (Red dwarf) Star
Kunab	K (Yellow-Orange) Star
Arietis Sector PV-B a14-4	Y (Brown dwarf) Star
Arietis Sector HJ-F a12-2	T (Brown dwarf) Star
Piscium Sector ES-S a4-1	T (Brown dwarf) Star
Dhakhan	G (White-Yellow) Star
Tan'gika	M (Red dwarf) Star
Guroji	M (Red dwarf) Star
Piscium Sector CH-U a3-4	Y (Brown dwarf) Star
Piscium Sector SF-N a7-1	L (Brown dwarf) Star
Midgard	G (White-Yellow) Star
Mbazak	T Tauri Star
Piscium Sector IC-V b2-0	T Tauri Star
Pegasi Sector HX-H a11-4	T Tauri Star
Arietis Sector BR-M b7-6	M (Red dwarf) Star
Piscium Sector SF-N a7-0	T Tauri Star
Piscium Sector GN-S a4-2	T (Brown dwarf) Star
Piscium Sector OZ-O a6-0	L (Brown dwarf) Star
Piscium Sector MI-T b3-7	T Tauri Star
Piscium Sector OZ-O a6-1	Y (Brown dwarf) Star
Mu Andromedae	A (Blue-White) Star
Hyades Sector LD-S c4-11	K (Yellow-Orange) Star
Cephei Sector BA-A d136	M (Red dwarf) Star
Kpannon Di	T Tauri Star
Piscium Sector AQ-Y c11	M (Red dwarf) Star
Arietis Sector VP-O b6-4	M (Red dwarf) Star
Cephei Sector FL-Y b1	M (Red dwarf) Star
Pegasi Sector RI-S b4-4	M (Red dwarf) Star
HR 303	F (White) Star
Arietis Sector PV-B a14-3	M (Red dwarf) Star
GMB 3689	K (Yellow-Orange giant) Star
HIP 116213	K (Yellow-Orange) Star
NN 3086 A	White Dwarf (D) Star
Arietis Sector RJ-Q b5-7	M (Red dwarf) Star
Arietis Sector HR-W d1-93	K (Yellow-Orange) Star
Hixkar	M (Red dwarf) Star
Col 285 Sector IT-W b16-4	M (Red dwarf) Star
Hyades Sector CF-S a19-3	T Tauri Star
BD+35 4893	K (Yellow-Orange) Star
Arietis Sector BI-H a11-2	L (Brown dwarf) Star
Tangpho	F (White) Star
Piscium Sector IC-V b2-6	T Tauri Star
Hyades Sector IG-Q a20-2	T Tauri Star
Piscium Sector ME-P a6-7	T (Brown dwarf) Star
Piscium Sector WL-L a8-3	L (Brown dwarf) Star
Kambila	M (Red dwarf) Star
Dofni	G (White-Yellow) Star
Col 285 Sector IT-W b16-3	M (Red dwarf) Star
Arietis Sector KC-V c2-20	K (Yellow-Orange) Star
Indrasians	M (Red dwarf) Star
Piscium Sector KT-Q a5-0	L (Brown dwarf) Star
Piscium Sector CH-U a3-2	T (Brown dwarf) Star
Hyades Sector GL-Q a20-4	T (Brown dwarf) Star
23 Andromedae	F (White) Star
Arietis Sector HJ-F a12-1	L (Brown dwarf) Star
Hyades Sector UV-L b8-8	M (Red dwarf) Star
Arietis Sector KC-V c2-12	K (Yellow-Orange) Star
Gram	K (Yellow-Orange) Star
Cephei Sector BA-A d100	T Tauri Star
HIP 4868	F (White) Star
Col 285 Sector EN-Y b15-3	M (Red dwarf) Star
Cephei Sector LM-W b1-8	M (Red dwarf) Star
Piscium Sector ME-P a6-0	L (Brown dwarf) Star
Piscium Sector DH-U a3-0	T (Brown dwarf) Star
Piscium Sector YE-A d76	G (White-Yellow) Star
Arietis Sector BR-M b7-5	M (Red dwarf) Star
Adensu	M (Red dwarf) Star
Pegasi Sector TD-S b4-6	M (Red dwarf) Star
Pegasi Sector TD-S b4-5	M (Red dwarf) Star
Piscium Sector MI-T b3-8	M (Red dwarf) Star
Herlio	G (White-Yellow) Star
Piscium Sector RK-N a7-1	L (Brown dwarf) Star
Piscium Sector ZA-W a2-1	T (Brown dwarf) Star
Hyades Sector HL-Q a20-3	Y (Brown dwarf) Star
Piscium Sector BM-U a3-1	Y (Brown dwarf) Star
Hyades Sector PJ-Q c5-15	K (Yellow-Orange) Star
Wolf 1232	K (Yellow-Orange) Star
Soma	G (White-Yellow) Star
Bletani	M (Red dwarf) Star
Arietis Sector RJ-Q b5-3	M (Red dwarf) Star
Piscium Sector JY-Q a5-0	L (Brown dwarf) Star
Cephei Sector BA-A d115	G (White-Yellow) Star
Enete	T Tauri Star
Piscium Sector HN-S a4-5	Y (Brown dwarf) Star
Paleni	T Tauri Star
Piscium Sector MI-T b3-6	M (Red dwarf) Star
HIP 1055	M (Red dwarf) Star
Wayano	M (Red dwarf) Star
Piscium Sector MI-T b3-3	M (Red dwarf) Star
Piscium Sector FS-S a4-1	Y (Brown dwarf) Star
Arietis Sector OA-C a14-0	M (Red dwarf) Star
Arietis Sector VZ-P b5-4	M (Red dwarf) Star
Arietis Sector CI-H a11-5	Y (Brown dwarf) Star
Arietis Sector CI-H a11-0	Y (Brown dwarf) Star
Piscium Sector HN-S a4-4	L (Brown dwarf) Star
Piscium Sector BM-U a3-0	T (Brown dwarf) Star
Piscium Sector GH-V b2-8	T Tauri Star
Piscium Sector TF-N a7-4	T (Brown dwarf) Star
Hyades Sector HL-Q a20-4	T (Brown dwarf) Star
Hyades Sector HL-Q a20-0	T (Brown dwarf) Star
Piscium Sector DH-U a3-1	L (Brown dwarf) Star
Arietis Sector KU-D a13-0	Y (Brown dwarf) Star
Wolf 4	K (Yellow-Orange) Star
Piscium Sector PZ-O a6-1	Y (Brown dwarf) Star
Karini	M (Red dwarf) Star
Hyades Sector HL-Q a20-1	L (Brown dwarf) Star
Arietis Sector MP-D a13-1	T (Brown dwarf) Star
Hyades Sector ZY-T a18-3	T Tauri Star
Arietis Sector RZ-O b6-7	M (Red dwarf) Star
Hyades Sector JG-Q a20-0	T (Brown dwarf) Star
Hyades Sector PJ-Q c5-27	K (Yellow-Orange) Star
Col 285 Sector EN-Y b15-4	M (Red dwarf) Star
Piscium Sector FS-S a4-0	T Tauri Star
Arietis Sector MP-D a13-2	T (Brown dwarf) Star
Arietis Sector GO-F a12-0	Y (Brown dwarf) Star
Piscium Sector HN-S a4-6	T (Brown dwarf) Star
BD+49 3937	K (Yellow-Orange) Star
Swahukcha	M (Red dwarf) Star
Piscium Sector GH-V b2-1	T Tauri Star
Piscium Sector JY-Q a5-3	Y (Brown dwarf) Star
Piscium Sector ZA-W a2-4	T (Brown dwarf) Star
Piscium Sector FS-S a4-2	T (Brown dwarf) Star
Col 285 Sector DM-L c8-19	G (White-Yellow) Star
Piscium Sector PZ-O a6-3	T (Brown dwarf) Star
Arietis Sector CI-H a11-1	T (Brown dwarf) Star
Orgetu	L (Brown dwarf) Star
Pegasi Sector PX-T b3-5	M (Red dwarf) Star
Piscium Sector PZ-O a6-2	L (Brown dwarf) Star
Arietis Sector GO-F a12-4	T (Brown dwarf) Star
Piscium Sector FS-S a4-4	T (Brown dwarf) Star
Kung Mu	M (Red dwarf) Star
Brangkalar	T (Brown dwarf) Star
Hyades Sector JG-Q a20-2	T (Brown dwarf) Star
HIP 8865	K (Yellow-Orange) Star
Saktassura	M (Red dwarf) Star
HIP 8753	K (Yellow-Orange) Star
Piscium Sector GH-V b2-5	M (Red dwarf) Star
Arietis Sector ZF-O b6-5	M (Red dwarf) Star
Piscium Sector IC-V b2-1	M (Red dwarf) Star
HIP 9151	F (White) Star
Piscium Sector JY-Q a5-1	T (Brown dwarf) Star
Piscium Sector JY-Q a5-2	T Tauri Star
Piscium Sector RK-N a7-2	T (Brown dwarf) Star
Hyades Sector YB-K b9-4	M (Red dwarf) Star
HIP 117336	M (Red dwarf) Star
Lucharn	F (White) Star
78 Piscium	F (White) Star
LHS 3931	K (Yellow-Orange) Star
Col 285 Sector IT-W b16-2	M (Red dwarf) Star
Pegasi Sector HB-X c1-21	K (Yellow-Orange) Star
Arietis Sector OA-C a14-1	L (Brown dwarf) Star
Piscium Sector JY-Q a5-4	T (Brown dwarf) Star
Arietis Sector BR-M b7-4	M (Red dwarf) Star
Piscium Sector NE-P a6-1	L (Brown dwarf) Star
Arietis Sector RJ-Q b5-1	M (Red dwarf) Star
Piscium Sector DH-U a3-4	Y (Brown dwarf) Star
Dakshey	M (Red dwarf) Star
Piscium Sector GH-V b2-2	M (Red dwarf) Star
Lalande 45165	G (White-Yellow) Star
Lalande 45165	G (White-Yellow) Star
Arietis Sector BR-M b7-3	M (Red dwarf) Star
HIP 1813	F (White) Star
Sadalbari	K (Yellow-Orange giant) Star
Piscium Sector LT-Q a5-3	T (Brown dwarf) Star
Piscium Sector RK-N a7-3	T (Brown dwarf) Star
Arietis Sector MP-D a13-3	M (Red dwarf) Star
Ogowen	K (Yellow-Orange) Star
Arietis Sector KC-V c2-7	G (White-Yellow) Star
Piscium Sector DH-U a3-3	T (Brown dwarf) Star
Djinaura	L (Brown dwarf) Star
Piscium Sector RK-N a7-0	Y (Brown dwarf) Star
HIP 6862	F (White) Star
Piscium Sector FS-S a4-3	Y (Brown dwarf) Star
Piscium Sector TF-N a7-3	Y (Brown dwarf) Star
Sambare	M (Red dwarf) Star
Piscium Sector XL-L a8-3	T (Brown dwarf) Star
Cephei Sector PS-U b2-3	M (Red dwarf) Star
Arietis Sector BR-M b7-1	M (Red dwarf) Star
Raguti	G (White-Yellow) Star
Piscium Sector LT-Q a5-2	T (Brown dwarf) Star
Hyades Sector YB-K b9-3	M (Red dwarf) Star
Wadjey'mi	M (Red dwarf) Star
Cephei Sector PS-U b2-2	M (Red dwarf) Star
Gucumadhyas	K (Yellow-Orange) Star
Ba Xian	M (Red dwarf) Star
Piscium Sector IC-V b2-5	M (Red dwarf) Star
Meinannovi	M (Red dwarf) Star
Piscium Sector LT-Q a5-4	T (Brown dwarf) Star
Cephei Sector JR-W b1-1	M (Red dwarf) Star
HIP 4103	G (White-Yellow) Star
Piscium Sector MI-T b3-2	M (Red dwarf) Star
HIP 6643	F (White) Star
Wuonjami	K (Yellow-Orange) Star
Piscium Sector KN-T b3-5	M (Red dwarf) Star
LTT 16764	K (Yellow-Orange) Star
Cephei Sector RD-T b3-4	M (Red dwarf) Star
Piscium Sector CL-Y d99	F (White) Star
Arietis Sector QV-B a14-1	T Tauri Star
Piscium Sector KN-T b3-3	M (Red dwarf) Star
Piscium Sector TF-N a7-0	L (Brown dwarf) Star
Arietis Sector VP-O b6-1	M (Red dwarf) Star
Aonikenk	K (Yellow-Orange) Star
Piscium Sector LT-Q a5-1	T (Brown dwarf) Star
LHS 3982	G (White-Yellow) Star
Kachinas	M (Red dwarf) Star
Piscium Sector QO-R b4-6	M (Red dwarf) Star
Maratians	M (Red dwarf) Star
Arietis Sector GO-F a12-3	M (Red dwarf) Star
Havasupai	M (Red dwarf) Star
Bagalis	M (Red dwarf) Star
Cephei Sector NX-U b2-5	M (Red dwarf) Star
Piscium Sector GR-W c1-17	G (White-Yellow) Star
Piscium Sector BM-U a3-3	L (Brown dwarf) Star
Arietis Sector MP-D a13-0	Y (Brown dwarf) Star
HIP 8728	K (Yellow-Orange) Star
Ndjabog	K (Yellow-Orange) Star
Orishanann	K (Yellow-Orange) Star
Undin	T Tauri Star
Piscium Sector LT-Q a5-0	L (Brown dwarf) Star
Piscium Sector NE-P a6-0	L (Brown dwarf) Star
HIP 6975	F (White) Star
Piscium Sector GR-W c1-24	K (Yellow-Orange) Star
Piscium Sector GH-V b2-3	M (Red dwarf) Star
T'a Shakarwa	M (Red dwarf) Star
HR 415	F (White) Star
Piscium Sector TF-N a7-1	L (Brown dwarf) Star
Arietis Sector GO-F a12-1	T (Brown dwarf) Star
Piscium Sector OD-T b3-1	M (Red dwarf) Star
HIP 8067	K (Yellow-Orange) Star
HIP 7090	G (White-Yellow) Star
Piscium Sector GH-V b2-6	M (Red dwarf) Star
Arietis Sector DM-M b7-5	T Tauri Star
Arietis Sector DM-M b7-1	M (Red dwarf) Star
Kutnal	M (Red dwarf) Star
Arietis Sector IJ-F a12-1	Y (Brown dwarf) Star
Bumbur	M (Red dwarf) Star
Medzisti	M (Red dwarf) Star
Cephei Sector JR-W b1-3	M (Red dwarf) Star
V344 Andromedae	G (White-Yellow) Star
Arietis Sector RJ-Q b5-2	M (Red dwarf) Star
Arietis Sector XK-O b6-5	M (Red dwarf) Star
Piscium Sector VU-X a1-2	T (Brown dwarf) Star
Arietis Sector CI-H a11-2	L (Brown dwarf) Star
Piscium Sector XL-L a8-2	T (Brown dwarf) Star
Piscium Sector HN-S a4-0	T Tauri Star
BD+15 4829	M (Red dwarf) Star
Arietis Sector IJ-F a12-3	L (Brown dwarf) Star
Piscium Sector BM-U a3-2	T Tauri Star
Arietis Sector GO-F a12-2	T (Brown dwarf) Star
Piscium Sector OD-T b3-2	M (Red dwarf) Star
Piscium Sector DH-U a3-2	T (Brown dwarf) Star
Piscium Sector CL-Y c14	K (Yellow-Orange) Star
HIP 11273	K (Yellow-Orange) Star
Piscium Sector EW-W b1-2	M (Red dwarf) Star
Qama	K (Yellow-Orange) Star
Tz'utumu	M (Red dwarf) Star
Piscium Sector KN-T b3-1	M (Red dwarf) Star
Arietis Sector RJ-Q b5-5	M (Red dwarf) Star
Piscium Sector MI-T b3-1	T Tauri Star
Piscium Sector CL-Y c27	K (Yellow-Orange) Star
Piscium Sector PZ-O a6-0	L (Brown dwarf) Star
Piscium Sector TF-N a7-2	Y (Brown dwarf) Star
Piscium Sector HN-S a4-3	T (Brown dwarf) Star
Piscium Sector VQ-L a8-3	Y (Brown dwarf) Star
Arietis Sector KU-D a13-1	T (Brown dwarf) Star
Cephei Sector RD-T b3-3	M (Red dwarf) Star
Arietis Sector IJ-F a12-0	L (Brown dwarf) Star
LHS 3705	K (Yellow-Orange) Star
HIP 999	G (White-Yellow) Star
Cephei Sector PS-U b2-6	T Tauri Star
Piscium Sector HN-S a4-1	Y (Brown dwarf) Star
Piscium Sector HN-S a4-2	T (Brown dwarf) Star
Cephei Sector JR-W b1-4	M (Red dwarf) Star
Piscium Sector GH-V b2-4	M (Red dwarf) Star
Arietis Sector IJ-F a12-2	T (Brown dwarf) Star
Arietis Sector KU-D a13-4	T (Brown dwarf) Star
HIP 10403	F (White) Star
Ross 546	K (Yellow-Orange) Star
Juan	K (Yellow-Orange) Star
HIP 2725	K (Yellow-Orange) Star
Pegasi Sector MR-V b2-2	M (Red dwarf) Star
Mecht	K (Yellow-Orange) Star
Paiyungh	T Tauri Star
Tsongoris	M (Red dwarf) Star
Hyades Sector DI-I b10-7	M (Red dwarf) Star
Piscium Sector EH-U a3-3	T (Brown dwarf) Star
Wunab	T Tauri Star
Piscium Sector OE-P a6-0	M (Red dwarf) Star
Piscium Sector LN-T b3-2	M (Red dwarf) Star
Oicolmas	K (Yellow-Orange) Star
Arietis Sector LU-D a13-2	T (Brown dwarf) Star
Arietis Sector HO-F a12-5	T (Brown dwarf) Star
Hyades Sector PJ-Q c5-22	G (White-Yellow) Star
Piscium Sector EH-U a3-1	T Tauri Star
Piscium Sector YL-L a8-1	T (Brown dwarf) Star
Arietis Sector DI-H a11-0	L (Brown dwarf) Star
Draga	K (Yellow-Orange) Star
Hyades Sector XG-K b9-1	M (Red dwarf) Star
Piscium Sector WQ-L a8-1	T Tauri Star
Arietis Sector NP-D a13-2	Y (Brown dwarf) Star
Piscium Sector JC-V b2-2	M (Red dwarf) Star
Piscium Sector AB-W a2-3	Y (Brown dwarf) Star
Karsu	M (Red dwarf) Star
6 Andromedae	F (White) Star
Piscium Sector UF-N a7-2	Y (Brown dwarf) Star
Piscium Sector HX-T b3-3	M (Red dwarf) Star
Wilastsi	M (Red dwarf) Star
Piscium Sector IN-S a4-2	L (Brown dwarf) Star
Piscium Sector AB-W a2-2	T Tauri Star
Piscium Sector JC-V b2-5	M (Red dwarf) Star
Piscium Sector SK-N a7-0	L (Brown dwarf) Star
Arietis Sector JJ-F a12-4	T (Brown dwarf) Star
Copian Xing	T Tauri Star
HIP 493	F (White) Star
Carenes	K (Yellow-Orange) Star
Ariga	T Tauri Star
Piscium Sector DB-X b1-2	M (Red dwarf) Star
HIP 495	K (Yellow-Orange) Star
Piscium Sector HH-V b2-4	M (Red dwarf) Star
Piscium Sector QZ-O a6-4	T (Brown dwarf) Star
Piscium Sector GS-S a4-1	L (Brown dwarf) Star
Arietis Sector OT-Q b5-4	M (Red dwarf) Star
Piscium Sector OE-P a6-1	T (Brown dwarf) Star
Piscium Sector DB-X b1-4	M (Red dwarf) Star
Piscium Sector IN-S a4-1	T Tauri Star
Arietis Sector HO-F a12-0	Y (Brown dwarf) Star
Piscium Sector MT-Q a5-1	Y (Brown dwarf) Star
Piscium Sector KY-Q a5-0	T (Brown dwarf) Star
Arietis Sector KC-V c2-21	K (Yellow-Orange) Star
Alexandrinus	G (White-Yellow) Star
Piscium Sector WQ-L a8-3	Y (Brown dwarf) Star
Gubiakum	M (Red dwarf) Star
Arietis Sector DI-H a11-2	Y (Brown dwarf) Star
Oris	M (Red dwarf) Star
Piscium Sector YL-L a8-3	T (Brown dwarf) Star
Piscium Sector LN-T b3-4	M (Red dwarf) Star
Piscium Sector DB-X b1-0	M (Red dwarf) Star
Piscium Sector YF-W a2-2	L (Brown dwarf) Star
Piscium Sector CM-U a3-1	L (Brown dwarf) Star
Piscium Sector QZ-O a6-0	T (Brown dwarf) Star
Arietis Sector JJ-F a12-3	T (Brown dwarf) Star
Arietis Sector NP-D a13-0	T Tauri Star
Piscium Sector IN-S a4-0	T (Brown dwarf) Star
AC +24 44	M (Red dwarf) Star
Arietis Sector HR-W d1-89	F (White) Star
Arietis Sector HR-W d1-91	K (Yellow-Orange) Star
Arietis Sector AG-O b6-4	T Tauri Star
Piscium Sector MT-Q a5-2	T (Brown dwarf) Star
Arietis Sector DI-H a11-1	Y (Brown dwarf) Star
Piscium Sector QZ-O a6-3	L (Brown dwarf) Star
Piscium Sector WQ-L a8-0	Y (Brown dwarf) Star
Sienses	T Tauri Star
Piscium Sector YF-W a2-4	Y (Brown dwarf) Star
Arietis Sector PA-C a14-0	L (Brown dwarf) Star
Piscium Sector GR-W c1-21	T Tauri Star
Mezavini	K (Yellow-Orange) Star
HIP 6978	G (White-Yellow) Star
Piscium Sector AB-W a2-0	Y (Brown dwarf) Star
Hyades Sector TA-M b8-0	M (Red dwarf) Star
Piscium Sector YF-W a2-1	T (Brown dwarf) Star
Uchagan	K (Yellow-Orange) Star
Daruwutja	M (Red dwarf) Star
Hyades Sector TA-M b8-6	M (Red dwarf) Star
Piscium Sector WQ-L a8-4	T (Brown dwarf) Star
Piscium Sector CM-U a3-2	L (Brown dwarf) Star
Piscium Sector HX-T b3-1	M (Red dwarf) Star
Ross 325	K (Yellow-Orange) Star
Piscium Sector OE-P a6-2	T (Brown dwarf) Star
Piscium Sector YU-Y c17	T Tauri Star
Bragpura	K (Yellow-Orange) Star
Piscium Sector LX-U b2-4	M (Red dwarf) Star
Inarajajara	F (White) Star
Piscium Sector YL-L a8-2	T Tauri Star
Piscium Sector QZ-O a6-1	T (Brown dwarf) Star
Yum Cimmeri	M (Red dwarf) Star
Piscium Sector HH-V b2-7	M (Red dwarf) Star
BD+41 283	F (White) Star
Arietis Sector KC-V c2-25	M (Red dwarf) Star
Piscium Sector LX-U b2-1	M (Red dwarf) Star
Ross 310	K (Yellow-Orange) Star
LP 349-73	K (Yellow-Orange) Star
Piscium Sector YF-W a2-0	T (Brown dwarf) Star
HIP 9067	M (Red dwarf) Star
Arikaras	M (Red dwarf) Star
Piscium Sector HH-V b2-5	T Tauri Star
Inovandar	M (Red dwarf) Star
Piscium Sector RO-R b4-1	M (Red dwarf) Star
Piscium Sector MT-Q a5-3	T (Brown dwarf) Star
Piscium Sector YF-W a2-3	Y (Brown dwarf) Star
HIP 5687	K (Yellow-Orange) Star
Piscium Sector MT-Q a5-6	T Tauri Star
Piscium Sector HH-V b2-0	M (Red dwarf) Star
HIP 7564	K (Yellow-Orange giant) Star
Andvaroges	K (Yellow-Orange) Star
Arietis Sector HO-F a12-1	T (Brown dwarf) Star
Gridii	K (Yellow-Orange) Star
Cephei Sector QS-U b2-5	M (Red dwarf) Star
Hupako	M (Red dwarf) Star
Polevnic	M (Red dwarf) Star
Piscium Sector JC-V b2-4	M (Red dwarf) Star
LP 195-25	K (Yellow-Orange) Star
HIP 7287	K (Yellow-Orange) Star
Bellite	K (Yellow-Orange) Star
Arietis Sector YK-O b6-3	M (Red dwarf) Star
Yalungurawa	G (White-Yellow) Star
Arietis Sector NP-D a13-5	Y (Brown dwarf) Star
Arietis Sector JJ-F a12-2	L (Brown dwarf) Star
Ross 239	K (Yellow-Orange) Star
Piscium Sector HX-T b3-4	M (Red dwarf) Star
Wolf 93	M (Red dwarf) Star
Piscium Sector HX-T b3-7	M (Red dwarf) Star
Arietis Sector NP-D a13-3	Y (Brown dwarf) Star
Piscium Sector DR-V b2-6	M (Red dwarf) Star
NLTT 639	K (Yellow-Orange) Star
36 Andromedae	K (Yellow-Orange giant) Star
Vigr	G (White-Yellow) Star
LHS 3980	M (Red dwarf) Star
Piscium Sector HH-V b2-6	M (Red dwarf) Star
Piscium Sector RO-R b4-2	T Tauri Star
Piscium Sector GS-S a4-0	L (Brown dwarf) Star
Piscium Sector ZK-X b1-5	M (Red dwarf) Star
Hastyat	T Tauri Star
Arietis Sector NP-D a13-4	T (Brown dwarf) Star
Piscium Sector ZU-Y b5	M (Red dwarf) Star
Arietis Sector LU-D a13-0	L (Brown dwarf) Star
Ruchbah	A (Blue-White) Star
LP 462-13	M (Red dwarf) Star
Piscium Sector HX-T b3-2	T Tauri Star
Arietis Sector YK-O b6-4	M (Red dwarf) Star
Piscium Sector HX-T b3-6	T Tauri Star
Unktomi	M (Red dwarf) Star
Piscium Sector NI-T b3-1	M (Red dwarf) Star
Piscium Sector MT-Q a5-4	Y (Brown dwarf) Star
Nez Perce	M (Red dwarf) Star
Piscium Sector DB-X b1-6	T Tauri Star
Arietis Sector DI-H a11-3	M (Red dwarf) Star
Lambda Andromedae	G (White-Yellow) Star
WSI 96	F (White) Star
Arietis Sector JJ-F a12-1	T (Brown dwarf) Star
Lu Wanja	F (White) Star
Nommarini	M (Red dwarf) Star
Piscium Sector WU-X a1-1	L (Brown dwarf) Star
BD+32 4747	F (White) Star
Piscium Sector EH-U a3-2	L (Brown dwarf) Star
LP 295-2	K (Yellow-Orange) Star
Arietis Sector LU-D a13-1	T Tauri Star
Koraga	K (Yellow-Orange) Star
Totjob'al	K (Yellow-Orange) Star
Delta Andromedae	K (Yellow-Orange giant) Star
Piscium Sector MT-Q a5-5	Y (Brown dwarf) Star
Piscium Sector ZU-Y b6	M (Red dwarf) Star
Caeramu Tie	M (Red dwarf) Star
Piscium Sector SK-N a7-1	L (Brown dwarf) Star
Piscium Sector BQ-Y b1	M (Red dwarf) Star
Piscium Sector FW-W b1-1	M (Red dwarf) Star
Arietis Sector UE-Q b5-5	M (Red dwarf) Star
Piscium Sector ZK-X b1-2	M (Red dwarf) Star
Piscium Sector WU-X a1-0	L (Brown dwarf) Star
Piscium Sector UZ-X a1-1	L (Brown dwarf) Star
Zoquala	T Tauri Star
Arietis Sector FD-H a11-2	Y (Brown dwarf) Star
NLTT 3478	M (Red dwarf) Star
Arietis Sector JJ-F a12-0	Y (Brown dwarf) Star
Arietis Sector HO-F a12-4	Y (Brown dwarf) Star
Piscium Sector KY-Q a5-1	L (Brown dwarf) Star
Bythos	G (White-Yellow) Star
Ssu Ling	G (White-Yellow) Star
Wolf 5	K (Yellow-Orange giant) Star
Piscium Sector NI-T b3-0	M (Red dwarf) Star
Guruku Yi	M (Red dwarf) Star
LHS 4008	K (Yellow-Orange) Star
Arietis Sector FD-H a11-3	T (Brown dwarf) Star
Hyades Sector ZB-K b9-6	M (Red dwarf) Star
Ugrivaci	M (Red dwarf) Star
Wodiwodi	K (Yellow-Orange) Star
Piscium Sector WQ-L a8-5	Y (Brown dwarf) Star
Piscium Sector GR-W c1-20	K (Yellow-Orange) Star
Piscium Sector HH-V b2-3	T Tauri Star
Maikoro	M (Red dwarf) Star
Maikoro	M (Red dwarf) Star
Kaupatak	K (Yellow-Orange) Star
Piscium Sector KY-Q a5-3	T (Brown dwarf) Star
Piscium Sector HX-T b3-5	M (Red dwarf) Star
BD+21 55	K (Yellow-Orange) Star
Alpheratz	B (Blue-White) Star
Piscium Sector MT-Q a5-0	T Tauri Star
Menhures	M (Red dwarf) Star
Arietis Sector HO-F a12-3	T (Brown dwarf) Star
Nastrond	G (White-Yellow) Star
7 Andromedae	F (White) Star
FZ Andromedae	M (Red dwarf) Star
Arietis Sector HO-F a12-2	L (Brown dwarf) Star
Piscium Sector WU-X a1-2	T (Brown dwarf) Star
Piscium Sector UZ-X a1-2	T Tauri Star
GCRV 74844	K (Yellow-Orange) Star
Arietis Sector IH-V c2-11	K (Yellow-Orange) Star
Hyades Sector ZB-K b9-5	M (Red dwarf) Star
Kolyawa	T (Brown dwarf) Star
Arietis Sector FD-H a11-1	T Tauri Star
Ross 244	M (Red dwarf) Star
Arietis Sector YK-O b6-5	M (Red dwarf) Star
AC +60 40462	K (Yellow-Orange) Star
Piscium Sector RZ-O a6-3	T (Brown dwarf) Star
Cephei Sector SD-T b3-6	M (Red dwarf) Star
Arietis Sector SJ-Q b5-5	M (Red dwarf) Star
Piscium Sector ZK-X b1-3	M (Red dwarf) Star
Piscium Sector FW-W b1-3	T Tauri Star
LFT 1667	M (Red dwarf) Star
Kudiyu	G (White-Yellow) Star
Ross 303	M (Red dwarf) Star
Piscium Sector LY-Q a5-0	T Tauri Star
Piscium Sector PE-P a6-1	M (Red dwarf) Star
Piscium Sector RZ-O a6-1	L (Brown dwarf) Star
Urvantju	L (Brown dwarf) Star
Arietis Sector MU-D a13-1	T (Brown dwarf) Star
Piscium Sector DM-U a3-0	T Tauri Star
Piscium Sector BB-W a2-0	L (Brown dwarf) Star
Cenoi	M (Red giant) Star
Piscium Sector BB-W a2-2	L (Brown dwarf) Star
Duacina	G (White-Yellow) Star
PPM 41187	K (Yellow-Orange) Star
Piscium Sector VZ-X a1-0	L (Brown dwarf) Star
Piscium Sector YE-A d87	M (Red dwarf) Star
Arietis Sector IO-F a12-0	L (Brown dwarf) Star
Piscium Sector ZU-Y b4	T Tauri Star
Piscium Sector ZL-L a8-0	Y (Brown dwarf) Star
Arietis Sector WZ-P b5-3	M (Red dwarf) Star
Arietis Sector OP-D a13-1	M (Red dwarf) Star
Arietis Sector GM-V c2-21	K (Yellow-Orange) Star
Piscium Sector NT-Q a5-3	Y (Brown dwarf) Star
Njokujinun	L (Brown dwarf) Star
Arietis Sector MU-D a13-2	T (Brown dwarf) Star
Hyades Sector ZB-K b9-4	M (Red dwarf) Star
Piscium Sector VZ-X a1-1	T (Brown dwarf) Star
Piscium Sector YU-Y c14	K (Yellow-Orange) Star
Mangkhwal	K (Yellow-Orange) Star
Arietis Sector KJ-F a12-2	Y (Brown dwarf) Star
Piscium Sector HS-S a4-1	Y (Brown dwarf) Star
Piscium Sector RZ-O a6-2	T Tauri Star
Arietis Sector KJ-F a12-1	L (Brown dwarf) Star
Rhibonii	M (Red dwarf) Star
NLTT 52635	M (Red dwarf) Star
Piscium Sector ZL-L a8-2	L (Brown dwarf) Star
Laukas	G (White-Yellow) Star
Draupnir	G (White-Yellow) Star
Piscium Sector EW-W c1-16	T Tauri Star
KZ Andromedae	K (Yellow-Orange) Star
Cound	K (Yellow-Orange) Star
Piscium Sector NT-Q a5-1	L (Brown dwarf) Star
Piscium Sector TK-N a7-0	Y (Brown dwarf) Star
Piscium Sector DM-U a3-4	T (Brown dwarf) Star
LTT 16910	K (Yellow-Orange) Star
4 Beta Trianguli	A (Blue-White) Star
Arietis Sector OP-D a13-0	L (Brown dwarf) Star
Arietis Sector KJ-F a12-0	L (Brown dwarf) Star
Piscium Sector LY-Q a5-1	L (Brown dwarf) Star
G 214-14	M (Red dwarf) Star
Arietis Sector MU-D a13-0	T (Brown dwarf) Star
Shana Bei	K (Yellow-Orange) Star
LHS 6394	M (Red dwarf) Star
Piscium Sector JN-S a4-0	T (Brown dwarf) Star
Piscium Sector FW-W b1-4	M (Red dwarf) Star
Piscium Sector PE-P a6-2	Y (Brown dwarf) Star
Piscium Sector ZF-W a2-1	Y (Brown dwarf) Star
Piscium Sector HS-S a4-0	L (Brown dwarf) Star
Jagantjin	T Tauri Star
Piscium Sector DM-U a3-3	T (Brown dwarf) Star
Pathan	K (Yellow-Orange) Star
LHS 6397	M (Red dwarf) Star
Wolf 1182	G (White-Yellow) Star
Jumana	M (Red dwarf) Star
Piscium Sector LY-Q a5-2	T Tauri Star
32 c Piscium	F (White) Star
Piscium Sector NT-Q a5-2	Y (Brown dwarf) Star
Wolf 10	M (Red dwarf) Star
Piscium Sector JN-S a4-1	L (Brown dwarf) Star
Howard	G (White-Yellow) Star
Wudjal	K (Yellow-Orange) Star
Piscium Sector PE-P a6-3	L (Brown dwarf) Star
Piscium Sector DR-V b2-7	M (Red dwarf) Star
BD+16 5027	K (Yellow-Orange) Star
Piscium Sector XQ-L a8-1	M (Red dwarf) Star
Piscium Sector ZK-X b1-0	M (Red dwarf) Star
Piscium Sector ZU-Y b7	M (Red dwarf) Star
HIP 2832	F (White) Star
LFT 1664	M (Red dwarf) Star
Zenus	G (White-Yellow) Star
Piscium Sector NT-Q a5-0	L (Brown dwarf) Star
Kuwan Slavs	K (Yellow-Orange) Star
Piscium Sector XU-X a1-1	L (Brown dwarf) Star
Hyades Sector LD-S c4-20	K (Yellow-Orange) Star
Piscium Sector ZF-W a2-2	Y (Brown dwarf) Star
Piscium Sector TK-N a7-1	M (Red dwarf) Star
Piscium Sector LX-U b2-3	M (Red dwarf) Star
GCRV 1526	K (Yellow-Orange) Star
Draguan Nu	M (Red dwarf) Star
Piscium Sector DM-U a3-2	T (Brown dwarf) Star
Piscium Sector XU-X a1-2	L (Brown dwarf) Star
Perit	G (White-Yellow) Star
NLTT 2969	M (Red dwarf) Star
GCRV 914	K (Yellow-Orange giant) Star
Wonorne Nu	K (Yellow-Orange) Star
Piscium Sector VF-N a7-0	L (Brown dwarf) Star
Elusughna	T Tauri Star
Arietis Sector IO-F a12-1	T Tauri Star
LHS 525	K (Yellow-Orange) Star
Piscium Sector HH-V b2-1	M (Red dwarf) Star
HIP 6796	K (Yellow-Orange) Star
Tamor	G (White-Yellow) Star
Piscium Sector HH-V b2-2	M (Red dwarf) Star
Piscium Sector ZU-Y b3	M (Red dwarf) Star
Arietis Sector UE-Q b5-3	M (Red dwarf) Star
Piscium Sector BQ-Y b0	M (Red dwarf) Star
Piscium Sector ZU-Y b2	M (Red dwarf) Star
LHS 3991	M (Red dwarf) Star
V447 Lacertae	K (Yellow-Orange) Star
Piscium Sector VF-N a7-2	L (Brown dwarf) Star
Piscium Sector AQ-Y c15	M (Red dwarf) Star
Hyades Sector ZB-K b9-2	T Tauri Star
Omega Andromedae	F (White) Star
V565 Persei	K (Yellow-Orange) Star
Arietis Sector EI-H a11-3	T (Brown dwarf) Star
Piscium Sector DB-X b1-3	M (Red dwarf) Star
Arimil	L (Brown dwarf) Star
Piscium Sector XU-X a1-0	L (Brown dwarf) Star
Piscium Sector FH-U a3-2	Y (Brown dwarf) Star
LTT 16838	K (Yellow-Orange) Star
Piscium Sector FW-W b1-6	M (Red dwarf) Star
NLTT 7316	M (Red dwarf) Star
Piscium Sector JC-V b2-6	T Tauri Star
Piscium Sector PE-P a6-0	Y (Brown dwarf) Star
G 232-62	M (Red dwarf) Star
Piscium Sector FH-U a3-1	M (Red dwarf) Star
Piscium Sector LD-S b4-7	M (Red dwarf) Star
Piscium Sector FW-W b1-5	M (Red dwarf) Star
Arietis Sector WZ-P b5-2	M (Red dwarf) Star
Devakak	K (Yellow-Orange) Star
Piscium Sector YE-A d86	M (Red dwarf) Star
Lodemovoi	M (Red dwarf) Star
Piscium Sector VZ-X a1-3	Y (Brown dwarf) Star
Piscium Sector XQ-L a8-0	T (Brown dwarf) Star
Tikariyomi	M (Red dwarf) Star
Piscium Sector BB-W a2-1	T (Brown dwarf) Star
Piscium Sector TK-N a7-2	L (Brown dwarf) Star
Ross 364	M (Red dwarf) Star
Piscium Sector NT-Q a5-5	T (Brown dwarf) Star
Piscium Sector NT-Q a5-4	T Tauri Star
Piscium Sector VZ-X a1-2	T (Brown dwarf) Star
Piscium Sector DM-U a3-5	Y (Brown dwarf) Star
Coquessa	M (Red dwarf) Star
Renson 570	F (White) Star
Arietis Sector SJ-Q b5-0	M (Red dwarf) Star
Nett	G (White-Yellow) Star
Piscium Sector DR-V b2-4	M (Red dwarf) Star
Piscium Sector JC-V b2-1	M (Red dwarf) Star
Piscium Sector JC-V b2-3	M (Red dwarf) Star
Piscium Sector ZU-Y b1	T Tauri Star
Hel	G (White-Yellow) Star
Glaucus	G (White-Yellow) Star
LHS 3946	K (Yellow-Orange) Star
Piscium Sector HR-W b1-1	T Tauri Star
MT Pegasi	G (White-Yellow) Star
Piscium Sector DM-U a3-1	Y (Brown dwarf) Star
Tirfing	G (White-Yellow) Star
Piscium Sector ZL-L a8-3	T (Brown dwarf) Star
Piscium Sector ZU-Y b0	M (Red dwarf) Star
Piscium Sector FH-U a3-0	T (Brown dwarf) Star
Piscium Sector FW-W b1-2	M (Red dwarf) Star
Arietis Sector UE-Q b5-4	T Tauri Star
Piscium Sector VF-N a7-1	Y (Brown dwarf) Star
TT 58343	M (Red dwarf) Star
BD+26 8	K (Yellow-Orange) Star
Piscium Sector JN-S a4-2	L (Brown dwarf) Star
G 218-5	K (Yellow-Orange) Star
HIP 7930	K (Yellow-Orange) Star
NLTT 1139	White Dwarf (DA) Star
LTT 10410	G (White-Yellow) Star
Piscium Sector WF-N a7-0	Y (Brown dwarf) Star
Piscium Sector WZ-X a1-1	T (Brown dwarf) Star
Aetius	K (Yellow-Orange) Star
Piscium Sector AV-Y b7	M (Red dwarf) Star
Anu	G (White-Yellow) Star
Piscium Sector WZ-X a1-4	L (Brown dwarf) Star
Arietis Sector LJ-F a12-1	L (Brown dwarf) Star
Arietis Sector LJ-F a12-3	T Tauri Star
Arietis Sector NU-D a13-4	L (Brown dwarf) Star
Piscium Sector IS-S a4-1	L (Brown dwarf) Star
LP 289-12	M (Red dwarf) Star
Ceti Sector VE-Z b1	M (Red dwarf) Star
Piscium Sector EM-U a3-0	T (Brown dwarf) Star
Piscium Sector WZ-X a1-0	Y (Brown dwarf) Star
Namnetes	M (Red dwarf) Star
Lidpar	M (Red dwarf) Star
Lidpar	M (Red dwarf) Star
Piscium Sector IS-S a4-2	T (Brown dwarf) Star
Arietis Sector HM-V c2-23	T Tauri Star
Piscium Sector UO-Z a0	Y (Brown dwarf) Star
Piscium Sector MY-Q a5-2	T (Brown dwarf) Star
Piscium Sector AG-W a2-0	T (Brown dwarf) Star
Piscium Sector OT-Q a5-1	T (Brown dwarf) Star
20 Arietis	F (White) Star
Arietis Sector JO-F a12-0	T (Brown dwarf) Star
Piscium Sector WF-N a7-1	T (Brown dwarf) Star
Arietis Sector LJ-F a12-2	L (Brown dwarf) Star
NLTT 2224	White Dwarf (DC) Star
Piscium Sector AM-L a8-1	L (Brown dwarf) Star
Piscium Sector OT-Q a5-2	L (Brown dwarf) Star
Piscium Sector YQ-L a8-0	Y (Brown dwarf) Star
Piscium Sector MY-Q a5-0	T (Brown dwarf) Star
Piscium Sector QD-T b3-0	M (Red dwarf) Star
Myrbat	G (White-Yellow) Star
Arietis Sector BG-O b6-5	M (Red dwarf) Star
Arietis Sector TZ-O b6-0	M (Red dwarf) Star
Lie Yu Kou	T Tauri Star
Piscium Sector MY-Q a5-3	Y (Brown dwarf) Star
Hyades Sector WV-L b8-2	M (Red dwarf) Star
HIP 10680	F (White) Star
BD+10 5022	K (Yellow-Orange) Star
Arietis Sector NU-D a13-3	Y (Brown dwarf) Star
LFT 1739	M (Red dwarf) Star
Piscium Sector IS-S a4-0	Y (Brown dwarf) Star
Narri	M (Red dwarf) Star
Piscium Sector GW-W b1-3	M (Red dwarf) Star
Purut	M (Red dwarf) Star
Piscium Sector AV-Y b6	M (Red dwarf) Star
Piscium Sector QE-P a6-0	T Tauri Star
9 Lambda Arietis	F (White) Star
HIP 10510	G (White-Yellow) Star
LHS 6408	M (Red dwarf) Star
LP 291-24	M (Red dwarf) Star
BD+52 3410	F (White) Star
Piscium Sector AM-L a8-0	Y (Brown dwarf) Star
Piscium Sector GH-U a3-1	T (Brown dwarf) Star
Arietis Sector LJ-F a12-0	T (Brown dwarf) Star
BD+23 204	G (White-Yellow) Star
Piscium Sector EB-X b1-6	M (Red dwarf) Star
Arietis Sector TZ-O b6-2	M (Red dwarf) Star
Piscium Sector ZU-Y c25	G (White-Yellow) Star
Egovach	M (Red dwarf) Star
Taribes	L (Brown dwarf) Star
Calarum	M (Red dwarf) Star
LTT 17047	K (Yellow-Orange) Star
Piscium Sector EM-U a3-1	L (Brown dwarf) Star
Piscium Sector KN-S a4-0	T (Brown dwarf) Star
Tripuna	M (Red dwarf) Star
V640 Cassiopeia	G (White-Yellow) Star
Piscium Sector AL-X b1-7	M (Red dwarf) Star
Piscium Sector SZ-O a6-0	Y (Brown dwarf) Star
Piscium Sector UK-N a7-1	Y (Brown dwarf) Star
Piscium Sector ZE-A c25	K (Yellow-Orange) Star
Piscium Sector WF-N a7-3	L (Brown dwarf) Star
BD+44 4389	K (Yellow-Orange) Star
Piscium Sector EM-U a3-2	Y (Brown dwarf) Star
LHS 1004	K (Yellow-Orange) Star
Piscium Sector QD-T b3-1	M (Red dwarf) Star
Caill Reddi	M (Red dwarf) Star
LP 350-75	K (Yellow-Orange) Star
Piscium Sector WF-N a7-2	Y (Brown dwarf) Star
Piscium Sector GH-U a3-0	M (Red dwarf) Star
16 Persei	F (White) Star
Adils	G (White-Yellow) Star
Skollung	K (Yellow-Orange) Star
Piscium Sector AL-X b1-6	M (Red dwarf) Star
Skappa	G (White-Yellow) Star
LHS 1275	G (White-Yellow) Star
NLTT 57506	M (Red dwarf) Star
Piscium Sector GW-W b1-1	M (Red dwarf) Star
9 Gamma Trianguli	A (Blue-White) Star
Piscium Sector ST-Z a2	T Tauri Star
Piscium Sector IR-W b1-5	T Tauri Star
Uelliodhino	M (Red dwarf) Star
Piscium Sector OT-Q a5-0	T Tauri Star
Piscium Sector CB-W a2-1	T (Brown dwarf) Star
Arietis Sector XZ-P b5-3	M (Red dwarf) Star
28 Omega Piscium	F (White) Star
ADS 16553	G (White-Yellow) Star
Arietis Sector VE-Q b5-0	M (Red dwarf) Star
Piscium Sector AV-Y b0	M (Red dwarf) Star
LHS 529	White Dwarf (DA) Star
HIP 7830	K (Yellow-Orange) Star
Arawoyn	L (Brown dwarf) Star
Piscium Sector YU-X a1-1	T Tauri Star
Piscium Sector WF-N a7-4	T (Brown dwarf) Star
EN Piscium	K (Yellow-Orange) Star
Arietis Sector TZ-O b6-1	M (Red dwarf) Star
Ambikul	M (Red dwarf) Star
Piscium Sector ZU-Y c26	K (Yellow-Orange) Star
Ross 298	M (Red dwarf) Star
Arietis Sector VE-Q b5-1	M (Red dwarf) Star
Piscium Sector YU-X a1-0	T (Brown dwarf) Star
Jadlillke	K (Yellow-Orange) Star
Piscium Sector OI-T b3-4	M (Red dwarf) Star
Piscium Sector YU-X a1-2	L (Brown dwarf) Star
27 Kappa Persei	G (White-Yellow) Star
Piscium Sector CQ-Y b2	M (Red dwarf) Star
StKM 2-77	K (Yellow-Orange) Star
Piscium Sector EL-Y b2	M (Red dwarf) Star
Zoryang	T Tauri Star
Arietis Sector HD-H a11-1	L (Brown dwarf) Star
LHS 6007	M (Red dwarf) Star
BD+28 4660	K (Yellow-Orange) Star
Dainbing	M (Red dwarf) Star
Zelada	M (Red dwarf) Star
Mirongkomi	M (Red dwarf) Star
Piscium Sector EB-X b1-5	M (Red dwarf) Star
Piscium Sector YU-X a1-3	T (Brown dwarf) Star
Piscium Sector IH-V b2-4	M (Red dwarf) Star
18 Lambda Piscium	A (Blue-White) Star
Gabien Ku	M (Red dwarf) Star
Pien Tsach	T Tauri Star
Piscium Sector CQ-Y b3	M (Red dwarf) Star
Gorringa	M (Red dwarf) Star
Piscium Sector WZ-X a1-2	T (Brown dwarf) Star
LP 346-49	M (Red dwarf) Star
Piscium Sector MX-U b2-3	M (Red dwarf) Star
Igaenisan	M (Red dwarf) Star
Wolf 926	M (Red dwarf) Star
Piscium Sector OT-Q a5-3	Y (Brown dwarf) Star
Piscium Sector AG-W a2-2	T (Brown dwarf) Star
Piscium Sector ST-Z a1	T Tauri Star
Piscium Sector GW-W b1-4	M (Red dwarf) Star
Ross 680	M (Red dwarf) Star
Arietis Sector JO-F a12-3	Y (Brown dwarf) Star
Piscium Sector DL-Y c21	K (Yellow-Orange) Star
Piscium Sector EL-Y b3	M (Red dwarf) Star
Yaringu	M (Red dwarf) Star
Guite	K (Yellow-Orange) Star
Arietis Sector JO-F a12-1	L (Brown dwarf) Star
Piscium Sector UO-Z a1	T Tauri Star
Piscium Sector SZ-O a6-2	Y (Brown dwarf) Star
Jarni	T Tauri Star
Volkhabe	M (Red dwarf) Star
Piscium Sector QD-T b3-4	T Tauri Star
GCRV 375	F (White) Star
LHS 4019	White Dwarf (DA) Star
MCC 378	K (Yellow-Orange) Star
BD+55 570	K (Yellow-Orange) Star
BD+55 570	K (Yellow-Orange) Star
Piscium Sector SZ-O a6-1	L (Brown dwarf) Star
G 172-15	M (Red dwarf) Star
Hecate	G (White-Yellow) Star
Piscium Sector QE-P a6-1	L (Brown dwarf) Star
Piscium Sector ST-Z a0	T (Brown dwarf) Star
SPOCS 111	K (Yellow-Orange) Star
GAT 1205	F (White) Star
LP 244-47	M (Red dwarf) Star
Njunmin	K (Yellow-Orange) Star
Kharwa	M (Red dwarf) Star
Arietis Sector JO-F a12-2	T Tauri Star
Yen Ti	G (White-Yellow) Star
Yerava	M (Red dwarf) Star
Ngati	K (Yellow-Orange) Star
Piscium Sector MY-Q a5-1	T (Brown dwarf) Star
Wolf 186	K (Yellow-Orange) Star
Piscium Sector AG-W a2-1	T (Brown dwarf) Star
LTT 18626	M (Red dwarf) Star
Piscium Sector QE-P a6-2	T (Brown dwarf) Star
G 241-62	M (Red dwarf) Star
Piscium Sector UO-Z a2	L (Brown dwarf) Star
Tegidana	M (Red dwarf) Star
Tegidana	M (Red dwarf) Star
Tegidana	M (Red dwarf) Star
Tegidana	M (Red dwarf) Star
Piscium Sector BM-L a8-0	L (Brown dwarf) Star
Kalak	M (Red dwarf) Star
Piscium Sector BG-W a2-2	T (Brown dwarf) Star
LHS 6386	M (Red dwarf) Star
NLTT 5369	M (Red dwarf) Star
Piscium Sector XF-N a7-0	L (Brown dwarf) Star
Piscium Sector LN-S a4-2	T (Brown dwarf) Star
Piscium Sector XZ-X a1-1	Y (Brown dwarf) Star
Li Tzicnii	K (Yellow-Orange) Star
Piscium Sector CQ-Y b6	M (Red dwarf) Star
Piscium Sector XZ-X a1-0	L (Brown dwarf) Star
Piscium Sector BG-W a2-0	L (Brown dwarf) Star
Piscium Sector AV-Y b2	M (Red dwarf) Star
Piscium Sector AV-Y b3	M (Red dwarf) Star
Piscium Sector EL-Y b4	M (Red dwarf) Star
Piscium Sector TZ-O a6-1	T (Brown dwarf) Star
BD+23 296	K (Yellow-Orange giant) Star
LTT 10624	F (White) Star
Piscium Sector DB-W a2-2	T (Brown dwarf) Star
Piscium Sector FM-U a3-0	Y (Brown dwarf) Star
Piscium Sector HH-U a3-1	T (Brown dwarf) Star
Kehperagwe	M (Red dwarf) Star
Arietis Sector KO-F a12-0	L (Brown dwarf) Star
Harpuligni	T Tauri Star
Piscium Sector PT-Q a5-0	T (Brown dwarf) Star
G 130-9	M (Red dwarf) Star
Kista	G (White-Yellow) Star
Piscium Sector PT-Q a5-5	Y (Brown dwarf) Star
LHS 1246	K (Yellow-Orange) Star
Piscium Sector LN-S a4-0	T Tauri Star
Piscium Sector KC-V b2-5	M (Red dwarf) Star
Piscium Sector ZQ-L a8-0	L (Brown dwarf) Star
Piscium Sector DB-W a2-1	T Tauri Star
Piscium Sector FM-U a3-1	T Tauri Star
Arietis Sector ID-H a11-0	T (Brown dwarf) Star
AGKR 1017	F (White) Star
Piscium Sector EB-X b1-3	M (Red dwarf) Star
Aymiay	G (White-Yellow) Star
Piscium Sector JS-S a4-2	T (Brown dwarf) Star
Piscium Sector PT-Q a5-1	T (Brown dwarf) Star
Nergal	T (Brown dwarf) Star
Tilo	M (Red dwarf) Star
Jastreb Sector YE-A d125	K (Yellow-Orange) Star
Piscium Sector PT-Q a5-6	Y (Brown dwarf) Star
NLTT 6655	M (Red dwarf) Star
Piscium Sector NY-Q a5-0	T (Brown dwarf) Star
Piscium Sector BG-W a2-1	T Tauri Star
LHS 3923	M (Red dwarf) Star
Piscium Sector TZ-O a6-0	L (Brown dwarf) Star
FF Andromedae	M (Red dwarf) Star
LHS 3859	M (Red dwarf) Star
Piscium Sector IR-W b1-1	M (Red dwarf) Star
Acokwa	K (Yellow-Orange) Star
Piscium Sector AV-Y b5	M (Red dwarf) Star
Piscium Sector BM-L a8-1	Y (Brown dwarf) Star
Kadjerong	K (Yellow-Orange) Star
Arietis Sector GI-H a11-3	L (Brown dwarf) Star
NLTT 8422	M (Red dwarf) Star
Piscium Sector VO-Z a0	T Tauri Star
Fomovithi	L (Brown dwarf) Star
Pardian	L (Brown dwarf) Star
Piscium Sector DB-W a2-0	L (Brown dwarf) Star
Piscium Sector EB-X b1-2	M (Red dwarf) Star
Khered	M (Red dwarf) Star
Sugana	M (Red dwarf) Star
Dymiay	G (White-Yellow) Star
Arietis Sector GI-H a11-0	Y (Brown dwarf) Star
Ross 9	K (Yellow-Orange) Star
Mwamba	T Tauri Star
Piscium Sector XF-N a7-2	Y (Brown dwarf) Star
Piscium Sector PT-Q a5-2	T (Brown dwarf) Star
Piscium Sector PT-Q a5-3	Y (Brown dwarf) Star
Piscium Sector JS-S a4-1	T (Brown dwarf) Star
Lemoerdhis	T Tauri Star
LTT 17149	K (Yellow-Orange) Star
LHS 137	M (Red dwarf) Star
Piscium Sector QD-T b3-5	M (Red dwarf) Star
Lalande 4855	G (White-Yellow) Star
Piscium Sector AV-Y b4	M (Red dwarf) Star
Kamchairra	M (Red dwarf) Star
LP 294-40	M (Red dwarf) Star
109 Piscium	G (White-Yellow) Star
Piscium Sector MX-U b2-2	M (Red dwarf) Star
Piscium Sector JS-S a4-3	Y (Brown dwarf) Star
Piscium Sector BM-L a8-2	Y (Brown dwarf) Star
BD+31 434	K (Yellow-Orange) Star
HR 244	F (White) Star
Ageno	M (Red dwarf) Star
Arietis Sector OU-D a13-1	T (Brown dwarf) Star
Arietis Sector VE-Q b5-5	M (Red dwarf) Star
Yin T'ien	K (Yellow-Orange) Star
Piscium Sector DL-Y c25	T Tauri Star
Arinna	K (Yellow-Orange) Star
Huiche	K (Yellow-Orange) Star
LHS 5386	M (Red dwarf) Star
Imango	M (Red dwarf) Star
Piscium Sector EB-X b1-0	M (Red dwarf) Star
Zorya	K (Yellow-Orange) Star
Piscium Sector PT-Q a5-4	Y (Brown dwarf) Star
BD-21 4791	G (White-Yellow) Star
Piscium Sector XF-N a7-1	T (Brown dwarf) Star
Arietis Sector PT-Q b5-4	M (Red dwarf) Star
Wolf 33	M (Red dwarf) Star
LHS 3947	K (Yellow-Orange) Star
Amenniya	L (Brown dwarf) Star
Piscium Sector VO-Z a3	Y (Brown dwarf) Star
Piscium Sector RE-P a6-2	Y (Brown dwarf) Star
MCC 418	M (Red dwarf) Star
BD+35 647	G (White-Yellow) Star
Hathor	K (Yellow-Orange) Star
HIP 11728	G (White-Yellow) Star
BD+15 176	K (Yellow-Orange) Star
LP 404-66	M (Red dwarf) Star
Guitaiku	M (Red dwarf) Star
NLTT 6667	M (Red dwarf) Star
Hyades Sector AC-K b9-7	M (Red dwarf) Star
Wolf 1515	K (Yellow-Orange) Star
Terra Mater	G (White-Yellow) Star
Arietis Sector KO-F a12-2	Y (Brown dwarf) Star
LP 347-5	M (Red dwarf) Star
Ross 788	K (Yellow-Orange) Star
Ausan	K (Yellow-Orange) Star
Aranka	K (Yellow-Orange) Star
Piscium Sector UJ-R b4-3	M (Red dwarf) Star
Piscium Sector HR-W c1-12	K (Yellow-Orange) Star
Piscium Sector VK-N a7-2	Y (Brown dwarf) Star
Piscium Sector UJ-R b4-5	M (Red dwarf) Star
Lan Gundi	M (Red dwarf) Star
Piscium Sector QD-T b3-3	M (Red dwarf) Star
Segon	M (Red dwarf) Star
Nagarans	M (Red dwarf) Star
Piscium Sector ZU-X a1-1	T (Brown dwarf) Star
Piscium Sector FM-U a3-2	T (Brown dwarf) Star
Piscium Sector RE-P a6-1	Y (Brown dwarf) Star
Jastreb Sector EW-W b1-5	L (Brown dwarf) Star
Ross 249	M (Red dwarf) Star
13 Trianguli	G (White-Yellow) Star
13 Trianguli	G (White-Yellow) Star
13 Trianguli	G (White-Yellow) Star
Wolf 64	K (Yellow-Orange) Star
LHS 3948	M (Red dwarf) Star
Piscium Sector ZU-X a1-2	L (Brown dwarf) Star
Sabihilo	M (Red dwarf) Star
LP 193-564	M (Red dwarf) Star
LP 149-14	M (Red dwarf) Star
Caph	F (White) Star
Umpilakap	Y (Brown dwarf) Star
Arietis Sector TJ-Q b5-4	M (Red dwarf) Star
Piscium Sector JS-S a4-0	T (Brown dwarf) Star
Piscium Sector XZ-X a1-3	T Tauri Star
Piscium Sector TT-Z a5	Y (Brown dwarf) Star
80 e Piscium	F (White) Star
Gliese 3008	K (Yellow-Orange) Star
Piscium Sector VO-Z a1	T (Brown dwarf) Star
HIP 13644	K (Yellow-Orange) Star
Jastreb Sector ZA-O a6-5	Y (Brown dwarf) Star
Hyades Sector AC-K b9-6	M (Red dwarf) Star
LHS 103	M (Red dwarf) Star
Mudusitoq	K (Yellow-Orange) Star
BD+05 5244	K (Yellow-Orange) Star
Kagudi	L (Brown dwarf) Star
LHS 3978	M (Red dwarf) Star
Piscium Sector TT-Z a3	Y (Brown dwarf) Star
Piscium Sector TT-Z a0	Y (Brown dwarf) Star
HIP 10050	F (White) Star
102 Pi Piscium	F (White) Star
Piscium Sector EB-X b1-1	M (Red dwarf) Star
LP 291-34	M (Red dwarf) Star
Wolf 1225	M (Red dwarf) Star
Beldarkri	G (White-Yellow) Star
Piscium Sector IR-W b1-2	M (Red dwarf) Star
Piscium Sector WO-A b7	M (Red dwarf) Star
Piscium Sector HR-W c1-17	T Tauri Star
Hebe	G (White-Yellow) Star
LP 292-66	M (Red dwarf) Star
Hyades Sector AC-K b9-5	M (Red dwarf) Star
Angawal	M (Red dwarf) Star
Piscium Sector VK-N a7-1	T (Brown dwarf) Star
LP 245-17	A (Blue-White) Star
Piscium Sector RE-P a6-4	Y (Brown dwarf) Star
Piscium Sector ZE-A c24	T Tauri Star
Piscium Sector PT-Q a5-7	T (Brown dwarf) Star
Piscium Sector YJ-A b2	T Tauri Star
LTT 10462	M (Red dwarf) Star
Mitnahas	M (Red dwarf) Star
LHS 1068	M (Red dwarf) Star
Piscium Sector TT-Z a4	Y (Brown dwarf) Star
G 172-13	M (Red dwarf) Star
BD+02 4718	K (Yellow-Orange) Star
Piscium Sector ZQ-L a8-1	T Tauri Star
Arietis Sector TJ-Q b5-2	M (Red dwarf) Star
Inggale	T (Brown dwarf) Star
Warnates	K (Yellow-Orange) Star
Tascheter Sector IS-T a3-2	L (Brown dwarf) Star
Tascheter Sector MY-R a4-3	Y (Brown dwarf) Star
LTT 17383	M (Red dwarf) Star
Piscium Sector GW-W b1-5	M (Red dwarf) Star
LP 583-82	M (Red dwarf) Star
Piscium Sector VK-N a7-0	L (Brown dwarf) Star
Piscium Sector VK-N a7-3	Y (Brown dwarf) Star
LHS 1383	M (Red dwarf) Star
Brivitt	K (Yellow-Orange) Star
HIP 10175	G (White-Yellow) Star
Sussche	M (Red dwarf) Star
Sussche	M (Red dwarf) Star
Aeng Dimo	M (Red dwarf) Star
Algol	B (Blue-White) Star
Piscium Sector GW-W b1-6	M (Red dwarf) Star
Piscium Sector RE-P a6-0	T (Brown dwarf) Star
Piscium Sector UJ-R b4-4	M (Red dwarf) Star
Qi Yomisii	L (Brown dwarf) Star
Wolf 1324	K (Yellow-Orange) Star
GT Pegasi	M (Red dwarf) Star
Piscium Sector KC-V b2-2	T Tauri Star
Arietis Sector TJ-Q b5-3	M (Red dwarf) Star
G 69-11	M (Red dwarf) Star
Piscium Sector TZ-O a6-2	Y (Brown dwarf) Star
Piscium Sector JR-W b1-4	T Tauri Star
Piscium Sector WO-Z a2	T (Brown dwarf) Star
Piscium Sector HW-W b1-2	M (Red dwarf) Star
64 Piscium	F (White) Star
Tangaroa	G (White-Yellow) Star
Tascheter Sector RE-Q a5-0	T (Brown dwarf) Star
Wolf 12	K (Yellow-Orange) Star
Piscium Sector IH-U a3-1	L (Brown dwarf) Star
Piscium Sector WK-N a7-1	T Tauri Star
Caberani	T Tauri Star
Piscium Sector WO-Z a4	Y (Brown dwarf) Star
Piscium Sector IH-U a3-0	T Tauri Star
LHS 120	M (Red dwarf) Star
Piscium Sector UT-Z a1	L (Brown dwarf) Star
LTT 17016	M (Red dwarf) Star
Lalande 2450	G (White-Yellow) Star
Piscium Sector WO-Z a0	L (Brown dwarf) Star
Piscium Sector OY-Q a5-1	T (Brown dwarf) Star
Ququve	M (Red dwarf) Star
Piscium Sector IH-U a3-2	Y (Brown dwarf) Star
Jastreb Sector SO-R a4-0	T (Brown dwarf) Star
Piscium Sector UZ-O a6-1	L (Brown dwarf) Star
G 190-28	M (Red dwarf) Star
Piscium Sector JR-W b1-5	M (Red giant) Star
Piscium Sector WO-Z a1	T Tauri Star
Piscium Sector OY-Q a5-0	L (Brown dwarf) Star
Arietis Sector LO-F a12-0	L (Brown dwarf) Star
Baldr	G (White-Yellow) Star
Piscium Sector AR-L a8-0	T Tauri Star
LP 196-42	White Dwarf (DA) Star
LHS 524	M (Red dwarf) Star
Piscium Sector UT-Z a0	L (Brown dwarf) Star
Tascheter Sector JS-T a3-0	L (Brown dwarf) Star
Tascheter Sector PT-R a4-0	L (Brown dwarf) Star
Piscium Sector UZ-O a6-0	Y (Brown dwarf) Star
PLX 695	K (Yellow-Orange) Star
Piscium Sector MN-S a4-0	T Tauri Star
Tascheter Sector TZ-P a5-3	T (Brown dwarf) Star
Lembava	K (Yellow-Orange) Star
Piscium Sector WO-Z a3	Y (Brown dwarf) Star
Piscium Sector QT-Q a5-0	L (Brown dwarf) Star
Tascheter Sector LN-T a3-1	L (Brown dwarf) Star
LFT 42	M (Red dwarf) Star
Jastreb Sector SO-R a4-1	T (Brown dwarf) Star
93 Rho Piscium	F (White) Star
LFT 20	M (Red dwarf) Star
Piscium Sector UZ-O a6-2	T (Brown dwarf) Star
12 Persei	F (White) Star
Piscium Sector HW-W b1-3	M (Red dwarf) Star
LP 404-6	M (Red dwarf) Star
Tascheter Sector DB-X b1-6	M (Red dwarf) Star
Jastreb Sector AB-O a6-1	Y (Brown dwarf) Star
BD+47 977	M (Red dwarf) Star
Imantana	M (Red dwarf) Star
NLTT 8089	K (Yellow-Orange) Star
Piscium Sector FL-Y b3	M (Red dwarf) Star
Arietis Sector UJ-Q b5-1	M (Red dwarf) Star
Arietis Sector LO-F a12-1	T (Brown dwarf) Star
Piscium Sector SE-P a6-0	M (Red dwarf) Star
Core Sys Sector RO-R a4-1	T (Brown dwarf) Star
Arietis Sector NJ-F a12-0	Y (Brown dwarf) Star
Piscium Sector WK-N a7-0	L (Brown dwarf) Star
Hyades Sector XV-L b8-6	M (Red dwarf) Star
Piscium Sector QT-Q a5-1	T (Brown dwarf) Star
Tascheter Sector NY-R a4-0	L (Brown dwarf) Star
Piscium Sector NX-U b2-1	M (Red dwarf) Star
Tascheter Sector RE-Q a5-2	T Tauri Star
LHS 1348	M (Red dwarf) Star
Lalande 2682	K (Yellow-Orange) Star
Piscium Sector CM-L a8-0	L (Brown dwarf) Star
51 Pegasi	G (White-Yellow) Star
Umathudti	M (Red dwarf) Star
Piscium Sector FB-X b1-5	T Tauri Star
LTT 10311	K (Yellow-Orange) Star
Arietis Sector HI-H a11-0	T (Brown dwarf) Star
Faeger	K (Yellow-Orange) Star
HIP 14137	M (Red dwarf) Star
HIP 9599	K (Yellow-Orange) Star
Piscium Sector BV-Y b3	M (Red dwarf) Star
Primpo	M (Red dwarf) Star
Caldarn	K (Yellow-Orange) Star
Jemetani	K (Yellow-Orange) Star
LP 469-60	K (Yellow-Orange) Star
Lan Disk	K (Yellow-Orange) Star
LFT 324	M (Red dwarf) Star
LHS 1499	M (Red dwarf) Star
LHS 5027	K (Yellow-Orange) Star
Piscium Sector PI-T b3-0	M (Red dwarf) Star
Wolf 152	K (Yellow-Orange) Star
Tascheter Sector PT-R a4-3	T (Brown dwarf) Star
Arietis Sector YZ-P b5-4	M (Red dwarf) Star
Piscium Sector HW-W b1-5	M (Red dwarf) Star
Piscium Sector DL-Y d104	G (White-Yellow) Star
Piscium Sector JH-V b2-5	T Tauri Star
Ross 5	K (Yellow-Orange) Star
Tascheter Sector NY-R a4-1	T (Brown dwarf) Star
23 Arietis	F (White) Star
Piscium Sector UZ-O a6-3	T (Brown dwarf) Star
Albast	M (Red dwarf) Star
Djakunda	M (Red dwarf) Star
G 218-20	M (Red dwarf) Star
Piscium Sector PI-T b3-1	M (Red dwarf) Star
Piscium Sector YF-N a7-0	T (Brown dwarf) Star
LHS 153	White Dwarf (DA) Star
Eta Arietis	F (White) Star
LHS 1393	White Dwarf (D) Star
Piscium Sector JR-W b1-3	M (Red dwarf) Star
Lalande 4141	G (White-Yellow) Star
Jafnhau	M (Red dwarf) Star
Wolf 218	K (Yellow-Orange) Star
Fenrichua	M (Red dwarf) Star
Tascheter Sector DB-X a1-1	T (Brown dwarf) Star
Jangore	G (White-Yellow) Star
Ross 302	M (Red dwarf) Star
LHS 1289	M (Red dwarf) Star
Tascheter Sector LN-T a3-0	Y (Brown dwarf) Star
Parenni	M (Red dwarf) Star
NLTT 7805	K (Yellow-Orange) Star
Piscium Sector JR-W b1-2	M (Red dwarf) Star
Pikum	M (Red dwarf) Star
V374 Andromedae	K (Yellow-Orange) Star
Furuhjelm III-674	G (White-Yellow) Star
Tascheter Sector PT-R a4-2	T (Brown dwarf) Star
Piscium Sector HW-W b1-4	M (Red dwarf) Star
Njulngan	L (Brown dwarf) Star
Aasgananu	M (Red dwarf) Star
Tascheter Sector NY-R a4-2	T (Brown dwarf) Star
Jurua	F (White) Star
Imani	M (Red dwarf) Star
LP 353-51	M (Red dwarf) Star
Arietis Sector NJ-F a12-4	L (Brown dwarf) Star
Piscium Sector YF-N a7-1	L (Brown dwarf) Star
Arnemil	K (Yellow-Orange) Star
LP 298-7	M (Red dwarf) Star
Piscium Sector DQ-Y b4	T Tauri Star
Aten	M (Red dwarf) Star
Tascheter Sector VK-O a6-2	L (Brown dwarf) Star
Wolf 89	K (Yellow-Orange) Star
LP 466-235	M (Red dwarf) Star
Tascheter Sector LX-U b2-6	M (Red dwarf) Star
Arietis Sector UJ-Q b5-2	L (Brown dwarf) Star
LFT 214	M (Red dwarf) Star
Tascheter Sector XF-O a6-2	L (Brown dwarf) Star
LP 353-74	M (Red dwarf) Star
Arietis Sector UJ-Q b5-6	T Tauri Star
GCRV 2311	G (White-Yellow) Star
Piscium Sector FL-Y b2	T Tauri Star
LP 298-33	K (Yellow-Orange) Star
Arietis Sector LO-F a12-2	L (Brown dwarf) Star
Sisii	M (Red dwarf) Star
Sisii	M (Red dwarf) Star
Tascheter Sector LN-T a3-2	L (Brown dwarf) Star
Piscium Sector DQ-Y b5	M (Red dwarf) Star
HIP 11941	G (White-Yellow) Star
Piscium Sector XO-A b5	M (Red dwarf) Star
Piscium Sector PI-T b3-7	M (Red dwarf) Star
Conn	M (Red dwarf) Star
Tascheter Sector RE-Q a5-3	Y (Brown dwarf) Star
Raksha	M (Red dwarf) Star
Raksha	M (Red dwarf) Star
Tascheter Sector PT-R a4-1	Y (Brown dwarf) Star
EZ Piscium	M (Red dwarf) Star
Piscium Sector DL-Y c18	T Tauri Star
BD+00 197	K (Yellow-Orange) Star
Arietis Sector NJ-F a12-3	Y (Brown dwarf) Star
BD+11 309	G (White-Yellow) Star
Simarasir	K (Yellow-Orange) Star
Piscium Sector CM-L a8-2	T (Brown dwarf) Star
Bestia	G (White-Yellow) Star
G 30-26	M (Red dwarf) Star
Valtys	M (Red dwarf) Star
Tascheter Sector LN-T a3-3	L (Brown dwarf) Star
Piscium Sector CM-L a8-1	Y (Brown dwarf) Star
Piscium Sector PI-T b3-6	M (Red dwarf) Star
Metallah	F (White) Star
Tascheter Sector RE-Q a5-1	L (Brown dwarf) Star
Piscium Sector PI-T b3-3	M (Red dwarf) Star
Tascheter Sector XF-O a6-1	T (Brown dwarf) Star
Lumba	M (Red dwarf) Star
Artume	G (White-Yellow) Star
NLTT 7941	M (Red dwarf) Star
Tascheter Sector JS-T a3-2	T (Brown dwarf) Star
Tascheter Sector JS-T a3-1	L (Brown dwarf) Star
Jastreb Sector BB-O a6-2	Y (Brown dwarf) Star
Tascheter Sector SE-Q a5-1	T (Brown dwarf) Star
Momus Reach	K (Yellow-Orange) Star
Piscium Sector VZ-O a6-2	Y (Brown dwarf) Star
Piscium Sector ZE-A c16	K (Yellow-Orange) Star
Tascheter Sector WK-O a6-2	T Tauri Star
Jastreb Sector XU-P a5-2	Y (Brown dwarf) Star
V439 Andromedae	G (White-Yellow) Star
Soturicari	L (Brown dwarf) Star
Tascheter Sector GM-V a2-2	T (Brown dwarf) Star
Ross 27	M (Red dwarf) Star
Piscium Sector DQ-Y b6	M (Red dwarf) Star
Jastreb Sector ZP-P a5-0	L (Brown dwarf) Star
LP 354-423	M (Red dwarf) Star
LP 298-52	M (Red dwarf) Star
Felkan	G (White-Yellow) Star
Tascheter Sector MN-T a3-4	T (Brown dwarf) Star
MET 20	G (White-Yellow) Star
Tascheter Sector YF-O a6-3	T (Brown dwarf) Star
Piscium Sector DQ-Y b3	T Tauri Star
Snoquot	M (Red dwarf) Star
Teleu	M (Red dwarf) Star
Jastreb Sector XU-P a5-0	L (Brown dwarf) Star
LHS 551	M (Red dwarf) Star
Tascheter Sector WK-O a6-0	T (Brown dwarf) Star
Ross 34	K (Yellow-Orange) Star
BD+31 630	K (Yellow-Orange) Star
GCRV 1568	G (White-Yellow) Star
Piscium Sector ZF-N a7-0	T (Brown dwarf) Star
Peneng Wa	M (Red dwarf) Star
Piscium Sector XO-A b3	M (Red dwarf) Star
LP 355-64	M (Red dwarf) Star
Jastreb Sector BB-O a6-3	T Tauri Star
Tascheter Sector KS-T a3-0	L (Brown dwarf) Star
LHS 151	White Dwarf (DAZ) Star
Hakkinoha	T Tauri Star
Tascheter Sector OY-R a4-2	Y (Brown dwarf) Star
Piscium Sector PI-T b3-4	M (Red dwarf) Star
Tascheter Sector YF-O a6-0	T Tauri Star
Tascheter Sector QT-R a4-1	Y (Brown dwarf) Star
Shedi	F (White) Star
Jumukun	K (Yellow-Orange) Star
Ross 346	M (Red dwarf) Star
Addovices	Y (Brown dwarf) Star
Chel	K (Yellow-Orange) Star
Tascheter Sector OY-R a4-3	Y (Brown dwarf) Star
Tascheter Sector IH-V a2-3	T (Brown dwarf) Star
Tascheter Sector IH-V a2-0	M (Red dwarf) Star
Tascheter Sector EW-W c1-29	G (White-Yellow) Star
Tascheter Sector QT-R a4-0	T (Brown dwarf) Star
Tascheter Sector WK-O a6-1	L (Brown dwarf) Star
LFT 204	M (Red dwarf) Star
LP 410-81	M (Red dwarf) Star
Jastreb Sector BB-O a6-1	T (Brown dwarf) Star
Tascheter Sector GM-V a2-0	T (Brown dwarf) Star
Wolf 225	K (Yellow-Orange) Star
Tascheter Sector CG-X a1-1	T (Brown dwarf) Star
Piscium Sector VZ-O a6-0	L (Brown dwarf) Star
Arietis Sector KD-H a11-2	T (Brown dwarf) Star
Core Sys Sector QD-T a3-5	T (Brown dwarf) Star
Kolaga	M (Red dwarf) Star
LP 462-19	M (Red dwarf) Star
Alanaribri	M (Red dwarf) Star
Tascheter Sector MN-T a3-3	T Tauri Star
Tascheter Sector YF-O a6-4	Y (Brown dwarf) Star
Jastreb Sector FH-M a7-0	T (Brown dwarf) Star
LHS 5037a	M (Red dwarf) Star
LP 465-77	M (Red dwarf) Star
LHS 1168	M (Red dwarf) Star
LP 299-53	M (Red dwarf) Star
Tascheter Sector GM-V a2-3	T (Brown dwarf) Star
LTT 74	K (Yellow-Orange) Star
Arietis Sector II-H a11-4	T (Brown dwarf) Star
Piscium Sector RT-Q a5-1	Y (Brown dwarf) Star
LFT 6	M (Red dwarf) Star
Michael Pantazis	K (Yellow-Orange) Star
Jastreb Sector BB-O a6-0	T (Brown dwarf) Star
Piscium Sector RT-Q a5-3	T Tauri Star
Piscium Sector RT-Q a5-2	Y (Brown dwarf) Star
Wolf 87	M (Red dwarf) Star
Wolf 1051	M (Red dwarf) Star
Core Sys Sector SO-R a4-1	L (Brown dwarf) Star
Arietis Sector WE-Q b5-3	M (Red dwarf) Star
Jastreb Sector XU-P a5-1	L (Brown dwarf) Star
Bama	T Tauri Star
Piscium Sector DM-L a8-0	T Tauri Star
LHS 112	M (Red dwarf) Star
Corbin	M (Red dwarf) Star
47 Arietis	F (White) Star
G 173-39	M (Red dwarf) Star
Piscium Sector DQ-Y b2	M (Red dwarf) Star
Beetrix	G (White-Yellow) Star
BD+01 299	K (Yellow-Orange) Star
Wolf 116	M (Red dwarf) Star
Piscium Sector DL-Y c16	T Tauri Star
Tascheter Sector YF-O a6-1	L (Brown dwarf) Star
LHS 1038	White Dwarf (DA) Star
Bao Yan Luo	K (Yellow-Orange) Star
Piscium Sector ZF-N a7-4	T Tauri Star
Piscium Sector DM-L a8-1	L (Brown dwarf) Star
Piscium Sector LC-V b2-4	M (Red dwarf) Star
Tascheter Sector GM-V a2-4	Y (Brown dwarf) Star
Tascheter Sector GM-V a2-1	T Tauri Star
LHS 6045	M (Red dwarf) Star
LFT 98	M (Red dwarf) Star
Rho Arietis	F (White) Star
Tascheter Sector OY-R a4-0	L (Brown dwarf) Star
Arietis Sector KD-H a11-5	L (Brown dwarf) Star
Horus	M (Red dwarf) Star
Piscium Sector RD-T b3-4	M (Red dwarf) Star
25 Arietis	F (White) Star
Hyades Sector XV-L b8-3	M (Red dwarf) Star
Tascheter Sector CG-X a1-2	L (Brown dwarf) Star
VVO 35	K (Yellow-Orange) Star
Core Sys Sector OI-T a3-1	L (Brown dwarf) Star
Hamal	K (Yellow-Orange giant) Star
Upsilon Andromedae	F (White) Star
Hedetet	M (Red dwarf) Star
Albus	K (Yellow-Orange) Star
Yimakuapa	M (Red dwarf) Star
LHS 1052	M (Red dwarf) Star
LHS 119	M (Red dwarf) Star
Glete	M (Red dwarf) Star
Orishala	K (Yellow-Orange) Star
LTT 779	K (Yellow-Orange) Star
Karsinanari	M (Red dwarf) Star
Piscium Sector JH-V b2-3	M (Red dwarf) Star
Piscium Sector DM-L a8-2	T (Brown dwarf) Star
Itza	M (Red dwarf) Star
Gyton's Hope	M (Red dwarf) Star
Tascheter Sector UZ-P a5-0	M (Red dwarf) Star
Piscium Sector VZ-O a6-1	T (Brown dwarf) Star
Nyx	G (White-Yellow) Star
LHS 1141	K (Yellow-Orange giant) Star
Tascheter Sector EB-X a1-0	M (Red dwarf) Star
CK Arietis	M (Red dwarf) Star
LHS 1483	M (Red dwarf) Star
Tascheter Sector HH-V b2-6	M (Red dwarf) Star
Marson	T (Brown dwarf) Star
LFT 90	M (Red dwarf) Star
Arietis Sector WE-Q b5-5	T Tauri Star
LTT 10380	White Dwarf (DA) Star
Tascheter Sector SE-Q a5-2	Y (Brown dwarf) Star
29 Arietis	G (White-Yellow) Star
Tascheter Sector MN-T a3-1	L (Brown dwarf) Star
Tascheter Sector QT-R a4-2	T Tauri Star
31 Arietis	F (White) Star
BC Arietis	K (Yellow-Orange) Star
Lalande 1799	K (Yellow-Orange) Star
Tascheter Sector MN-T a3-2	T Tauri Star
LDS 883	K (Yellow-Orange) Star
Tascheter Sector IH-V a2-5	Y (Brown dwarf) Star
Remines	F (White) Star
Sliotar	G (White-Yellow) Star
BD+34 724	M (Red dwarf) Star
Tascheter Sector EB-X a1-1	L (Brown dwarf) Star
Piscium Sector ZF-N a7-3	Y (Brown dwarf) Star
Tascheter Sector OY-R a4-1	T (Brown dwarf) Star
GCRV 52788	K (Yellow-Orange) Star
Tascheter Sector KS-T a3-3	T (Brown dwarf) Star
G 35-15	M (Red dwarf) Star
Arietis Sector WE-Q b5-4	T Tauri Star
Tascheter Sector DB-X b1-4	M (Red dwarf) Star
Aulebegus	T Tauri Star
Meiri	G (White-Yellow) Star
Tascheter Sector CL-Y d135	K (Yellow-Orange) Star
40 Ceti	F (White) Star
LHS 117	M (Red dwarf) Star
LFT 140	M (Red dwarf) Star
Tascheter Sector KS-T a3-2	L (Brown dwarf) Star
Piscium Sector BV-Y b5	M (Red dwarf) Star
Tascheter Sector MN-T a3-0	L (Brown dwarf) Star
Mentor	G (White-Yellow) Star
38 Arietis	A (Blue-White) Star
LHS 1507	M (Red dwarf) Star
Sheratan	A (Blue-White) Star
Tascheter Sector QT-R a4-3	L (Brown dwarf) Star
LHS 1562	M (Red dwarf) Star
LHS 135	M (Red dwarf) Star
LHS 543	M (Red dwarf) Star
Piscium Sector LC-V b2-2	T Tauri Star
Wolf 46	M (Red dwarf) Star
Toci	M (Red dwarf) Star
Wolf 110	K (Yellow-Orange) Star
Iota Piscium	F (White) Star
Hoko	M (Red dwarf) Star
Tascheter Sector HH-V b2-5	M (Red dwarf) Star
Veneerd	G (White-Yellow) Star
Tascheter Sector SE-Q a5-0	L (Brown dwarf) Star
112 Piscium	G (White-Yellow) Star
LAWD 8	White Dwarf (DQ) Star
LTT 149	G (White-Yellow) Star
Tascheter Sector LX-U b2-1	M (Red dwarf) Star
LHS 1366	M (Red dwarf) Star
Shenich	K (Yellow-Orange) Star
Capukanga	M (Red dwarf) Star
LHS 1230	K (Yellow-Orange) Star
Vendemo	M (Red dwarf) Star
Tascheter Sector WK-O a6-3	Y (Brown dwarf) Star
Piscium Sector DL-Y d118	T Tauri Star
Ceti Sector WE-Z b5	M (Red dwarf) Star
Piscium Sector LC-V b2-3	M (Red dwarf) Star
G 95-22	M (Red dwarf) Star
13 Ceti	F (White) Star
LHS 1226	M (Red dwarf) Star
Tascheter Sector IH-V a2-1	Y (Brown dwarf) Star
Tascheter Sector KS-T a3-1	Y (Brown dwarf) Star
Piscium Sector LC-V b2-5	M (Red dwarf) Star
Wolf 127	M (Red dwarf) Star
Tascheter Sector CL-Y d132	F (White) Star
FT Piscium	M (Red dwarf) Star
Piscium Sector VZ-O a6-3	T (Brown dwarf) Star
NLTT 6637	M (Red dwarf) Star
Core Sys Sector QD-T a3-2	T Tauri Star
LTT 11383	K (Yellow-Orange) Star
G 173-53	M (Red dwarf) Star
LP 470-30	M (Red dwarf) Star
Core Sys Sector QD-T a3-1	T Tauri Star
Tascheter Sector IH-V a2-2	T (Brown dwarf) Star
Core Sys Sector RD-T a3-2	L (Brown dwarf) Star
Piscium Sector IW-W b1-2	M (Red dwarf) Star
Inhers	M (Red dwarf) Star
LTT 453	M (Red dwarf) Star
LP 404-33	M (Red dwarf) Star
Tascheter Sector HM-V a2-0	L (Brown dwarf) Star
MCC 401	M (Red dwarf) Star
BoB	M (Red dwarf) Star
LTT 10823	K (Yellow-Orange) Star
Ainunnicori	M (Red dwarf) Star
V388 Cassiopeiae	M (Red dwarf) Star
Tascheter Sector NN-T a3-4	T (Brown dwarf) Star
Tascheter Sector JH-V a2-4	T (Brown dwarf) Star
Tascheter Sector ZF-O a6-0	T (Brown dwarf) Star
Crevit	G (White-Yellow) Star
Tascheter Sector HM-V a2-2	T (Brown dwarf) Star
Obato	L (Brown dwarf) Star
Tascheter Sector VZ-P a5-0	L (Brown dwarf) Star
Zhao Tzu	L (Brown dwarf) Star
Wolf 1325	M (Red dwarf) Star
51 Arietis	G (White-Yellow) Star
LP 704-74	M (Red dwarf) Star
Tascheter Sector DM-M a7-0	L (Brown dwarf) Star
Tascheter Sector FB-X a1-4	Y (Brown dwarf) Star
Tascheter Sector NN-T a3-0	T Tauri Star
LFT 160	M (Red dwarf) Star
LHS 1541	M (Red dwarf) Star
LTT 10838	K (Yellow-Orange) Star
Piscium Sector EL-Y c24	G (White-Yellow) Star
Tascheter Sector FB-X a1-5	Y (Brown dwarf) Star
Li Na	M (Red dwarf) Star
Tascheter Sector IR-W b1-2	M (Red dwarf) Star
LHS 1050	M (Red dwarf) Star
Khaima	K (Yellow-Orange) Star
Tascheter Sector HM-V a2-3	T (Brown dwarf) Star
Tascheter Sector BR-M a7-0	T (Brown dwarf) Star
LP 530-26	M (Red dwarf) Star
Tascheter Sector RT-R a4-0	Y (Brown dwarf) Star
Yax Balam	M (Red dwarf) Star
54 Piscium	K (Yellow-Orange) Star
Tascheter Sector HM-V a2-1	T (Brown dwarf) Star
StKM 1-276	M (Red dwarf) Star
BD+33 256	F (White) Star
Caribri	M (Red dwarf) Star
LHS 4003	M (Red dwarf) Star
Kwaraseti	F (White) Star
Rhiannon	T Tauri Star
Tascheter Sector LS-T a3-0	Y (Brown dwarf) Star
Tascheter Sector BR-M a7-1	Y (Brown dwarf) Star
Tascheter Sector FB-X a1-2	T (Brown dwarf) Star
Tascheter Sector FB-X a1-1	Y (Brown dwarf) Star
LP 355-65	White Dwarf (DC) Star
Tascheter Sector RT-R a4-2	T (Brown dwarf) Star
Piscium Sector EQ-Y b4	M (Red dwarf) Star
Julannsa	T Tauri Star
Tascheter Sector AV-Y b5	M (Red dwarf) Star
Tascheter Sector AV-Y b7	M (Red dwarf) Star
50 Persei	F (White) Star
Tascheter Sector AV-Y b6	M (Red dwarf) Star
Zhonvenk	M (Red dwarf) Star
Tascheter Sector ZF-O a6-1	Y (Brown dwarf) Star
Theta Persei	F (White) Star
Tascheter Sector IR-W b1-3	M (Red dwarf) Star
Tascheter Sector FB-X a1-0	Y (Brown dwarf) Star
Tascheter Sector ZZ-Y a2	M (Red dwarf) Star
Piscium Sector MC-V b2-7	L (Brown dwarf) Star
Wolf 1323	K (Yellow-Orange) Star
18 Ceti	G (White-Yellow) Star
18 Ceti	G (White-Yellow) Star
Ceti Sector XE-Z b5	M (Red dwarf) Star
Minerva	G (White-Yellow) Star
LP 298-42	M (Red dwarf) Star
Dinda	G (White-Yellow) Star
V491 Persei	G (White-Yellow) Star
G 158-59	M (Red dwarf) Star
Kou Zu	K (Yellow-Orange) Star
Garup	L (Brown dwarf) Star
Tascheter Sector ZZ-Y a1	Y (Brown dwarf) Star
LHS 1446	White Dwarf (DAZ) Star
Tirawishans	M (Red dwarf) Star
Keraitra	M (Red dwarf) Star
Piscium Sector SD-T b3-3	L (Brown dwarf) Star
Jastreb Sector CB-O a6-1	L (Brown dwarf) Star
Hoder	K (Yellow-Orange) Star
Core Sys Sector RD-T a3-1	Y (Brown dwarf) Star
Tote	M (Red dwarf) Star
Tascheter Sector RT-R a4-1	T (Brown dwarf) Star
LP 355-51	M (Red dwarf) Star
Jastreb Sector CB-O a6-0	T (Brown dwarf) Star
Ceti Sector WO-A c22	K (Yellow-Orange) Star
Tascheter Sector LS-T a3-5	T (Brown dwarf) Star
Tascheter Sector XK-O a6-0	T Tauri Star
Marduk	G (White-Yellow) Star
LP 469-73	M (Red dwarf) Star
Fyris Wolds	G (White-Yellow) Star
Ross 592	M (Red dwarf) Star
LHS 6028	M (Red dwarf) Star
Cemplatui	M (Red dwarf) Star
Tascheter Sector LS-T a3-3	L (Brown dwarf) Star
Ashandras	M (Red dwarf) Star
Tascheter Sector LS-T a3-1	T Tauri Star
Tascheter Sector CL-Y d133	K (Yellow-Orange) Star
LHS 71	K (Yellow-Orange) Star
LHS 1212	M (Red dwarf) Star
Tascheter Sector JH-V a2-0	T Tauri Star
Ceti Sector TY-A b3	M (Red dwarf) Star
Arietis Sector VJ-Q b5-2	M (Red dwarf) Star
Ikenga	K (Yellow-Orange) Star
Zeessze	K (Yellow-Orange) Star
LP 525-39	M (Red dwarf) Star
Psi Tauri	F (White) Star
Chankun	G (White-Yellow) Star
Tascheter Sector JH-V a2-1	Y (Brown dwarf) Star
Iota Persei	F (White) Star
WISE J000517	T (Brown dwarf) Star
Pirawoth	M (Red dwarf) Star
Tascheter Sector BQ-Y c21	K (Yellow-Orange) Star
Tascheter Sector LS-T a3-4	Y (Brown dwarf) Star
Tascheter Sector IR-W b1-4	M (Red dwarf) Star
Delta Trianguli	G (White-Yellow) Star
Tascheter Sector BV-Y a4	T (Brown dwarf) Star
LHS 1667	M (Red dwarf) Star
LHS 1453	K (Yellow-Orange) Star
Core Sys Sector RD-T a3-0	Y (Brown dwarf) Star
Bhadaba	G (White-Yellow) Star
LP 245-10	M (Red dwarf) Star
9 Ceti	G (White-Yellow) Star
LP 302-22	M (Red dwarf) Star
LHS 113	M (Red dwarf) Star
Tascheter Sector XK-O a6-1	Y (Brown dwarf) Star
Ceti Sector RD-B b1	M (Red dwarf) Star
Tascheter Sector BV-Y a3	L (Brown dwarf) Star
Kotigeni	M (Red dwarf) Star
Cochipati	M (Red dwarf) Star
Piscium Sector MC-V b2-6	M (Red dwarf) Star
Core Sys Sector VJ-R a4-3	Y (Brown dwarf) Star
Dongkum	M (Red dwarf) Star
LTT 11455	M (Red dwarf) Star
Tascheter Sector TE-Q a5-0	T (Brown dwarf) Star
LHS 1272	M (Red dwarf) Star
Liasstrata	K (Yellow-Orange giant) Star
Jastreb Sector GH-M a7-0	L (Brown dwarf) Star
Ladon	G (White-Yellow) Star
Bonde	M (Red dwarf) Star
Stafkarl	G (White-Yellow) Star
LTT 17422	M (Red dwarf) Star
LHS 1516	M (Red dwarf) Star
LP 356-106	M (Red dwarf) Star
Arietis Sector XE-Q b5-4	T Tauri Star
Cocontae	M (Red dwarf) Star
87 Mu Ceti	A (Blue-White) Star
LP 706-69	M (Red dwarf) Star
LFT 300	M (Red dwarf) Star
Tascheter Sector JH-V a2-2	L (Brown dwarf) Star
Tascheter Sector TE-Q a5-1	Y (Brown dwarf) Star
Ki	F (White) Star
LP 356-14	M (Red dwarf) Star
Tascheter Sector CL-Y d99	G (White-Yellow) Star
37 Ceti	F (White) Star
Ceti Sector TY-A b4	M (Red dwarf) Star
Kutnigi	M (Red dwarf) Star
Tascheter Sector NN-T a3-2	M (Red dwarf) Star
LAWD 7	White Dwarf (DA) Star
Tascheter Sector NN-T a3-3	Y (Brown dwarf) Star
Piscium Sector QI-T b3-6	T Tauri Star
LTT 569	M (Red dwarf) Star
Sui Xing	M (Red dwarf) Star
Eta Cassiopeiae	F (White) Star
Gooheimar	T Tauri Star
V1084 Tauri	G (White-Yellow) Star
EV Lacertae	M (Red dwarf) Star
Tascheter Sector HS-K a8-0	L (Brown dwarf) Star
Arietis Sector VJ-Q b5-1	M (Red dwarf) Star
Seediansi	T Tauri Star
LP 410-93	M (Red dwarf) Star
Tascheter Sector PY-R a4-0	T (Brown dwarf) Star
Wolf 1301	G (White-Yellow) Star
EQ Pegasi	M (Red dwarf) Star
Nekhbet	G (White-Yellow) Star
WISE J004945	T (Brown dwarf) Star
SPOCS 253	F (White) Star
Piscium Sector QI-T b3-5	M (Red dwarf) Star
Tascheter Sector JH-V a2-3	L (Brown dwarf) Star
LFT 325	M (Red dwarf) Star
Piscium Sector OX-U b2-4	M (Red dwarf) Star
Tomas	F (White) Star
LHS 1573	M (Red dwarf) Star
LHS 1084	M (Red dwarf) Star
Tascheter Sector EG-X a1-1	T (Brown dwarf) Star
Tascheter Sector KH-V a2-0	T (Brown dwarf) Star
NLTT 7719	M (Red dwarf) Star
Piscium Sector DL-Y d117	F (White) Star
Tascheter Sector GX-K a8-2	L (Brown dwarf) Star
Core Sys Sector SD-T a3-0	T (Brown dwarf) Star
LHS 1240	M (Red dwarf) Star
Tascheter Sector IS-K a8-2	T (Brown dwarf) Star
Tascheter Sector YK-O a6-0	Y (Brown dwarf) Star
Svaratia	K (Yellow-Orange) Star
BD+24 543	K (Yellow-Orange) Star
Struve 1321	K (Yellow-Orange) Star
Diphda	G (White-Yellow) Star
LP 467-16	M (Red dwarf) Star
Tascheter Sector EL-Y b6	M (Red dwarf) Star
Ndozins	M (Red dwarf) Star
Tascheter Sector GX-K a8-0	T (Brown dwarf) Star
BD-11 192	M (Red dwarf) Star
Wadjet	F (White) Star
Jastreb Sector FW-N a6-0	L (Brown dwarf) Star
Renetes	M (Red dwarf) Star
Piscium Sector IW-W b1-4	M (Red dwarf) Star
Piscium Sector MC-V b2-4	M (Red dwarf) Star
Tascheter Sector EM-M a7-0	T (Brown dwarf) Star
WISE 0146+4234	Y (Brown dwarf) Star
Seleru Bao	F (White) Star
Seleru Bao	F (White) Star
LHS 6050	M (Red dwarf) Star
Tascheter Sector IM-V a2-3	T (Brown dwarf) Star
Lalande 4268	G (White-Yellow) Star
Tascheter Sector WZ-P a5-0	T (Brown dwarf) Star
Arietis Sector XE-Q b5-6	M (Red dwarf) Star
Tascheter Sector GB-X a1-0	T Tauri Star
Kadi	T (Brown dwarf) Star
LHS 1443	M (Red dwarf) Star
Girya Gu	K (Yellow-Orange) Star
Mazu	G (White-Yellow) Star
KP Tauri	M (Red dwarf) Star
Abrocmii	M (Red dwarf) Star
Core Sys Sector UO-R a4-0	T (Brown dwarf) Star
Witchhaul	K (Yellow-Orange) Star
Tascheter Sector ST-R a4-2	T (Brown dwarf) Star
LFT 215	M (Red dwarf) Star
Tascheter Sector OS-U b2-3	M (Red dwarf) Star
Tascheter Sector MS-T a3-1	T Tauri Star
Tascheter Sector GB-X a1-2	T Tauri Star
Tarach Tor	G (White-Yellow) Star
Tascheter Sector CR-M a7-2	T (Brown dwarf) Star
Xang Tzu	T Tauri Star
2E 604	M (Red dwarf) Star
Tascheter Sector IM-V a2-4	T Tauri Star
Tascheter Sector GB-X a1-1	T Tauri Star
Tascheter Sector EG-X a1-0	L (Brown dwarf) Star
Piscium Sector EQ-Y b6	T Tauri Star
Ceti Sector XE-Z b0	M (Red dwarf) Star
Tascheter Sector QY-R a4-1	Y (Brown dwarf) Star
Mammentum	T (Brown dwarf) Star
LHS 163	M (Red dwarf) Star
Tascheter Sector GX-K a8-3	T Tauri Star
Kruger 60	M (Red dwarf) Star
LDS 46	K (Yellow-Orange) Star
Core Sys Sector WJ-R a4-0	L (Brown dwarf) Star
Jastreb Sector HH-M a7-2	T Tauri Star
Tascheter Sector EG-X a1-4	Y (Brown dwarf) Star
Tascheter Sector GX-K a8-1	Y (Brown dwarf) Star
Mehudti	M (Red dwarf) Star
Mantja	L (Brown dwarf) Star
Tascheter Sector IM-V a2-2	Y (Brown dwarf) Star
Moha	T Tauri Star
Piscium Sector MC-V b2-3	T Tauri Star
19 Phi-2 Ceti	F (White) Star
Tascheter Sector GB-X a1-5	T Tauri Star
Jastreb Sector HH-M a7-0	T Tauri Star
Tascheter Sector EG-X a1-3	T (Brown dwarf) Star
Tascheter Sector ON-T a3-0	L (Brown dwarf) Star
Byel Taca	M (Red dwarf) Star
Tascheter Sector IS-K a8-1	T (Brown dwarf) Star
LP 590-137	M (Red dwarf) Star
George Pantazis	K (Yellow-Orange) Star
Tascheter Sector ST-R a4-1	Y (Brown dwarf) Star
Aldr	K (Yellow-Orange) Star
LHS 1332	M (Red dwarf) Star
Ross 587	M (Red dwarf) Star
Tascheter Sector MN-T b3-6	M (Red dwarf) Star
Core Sys Sector SD-T a3-3	Y (Brown dwarf) Star
Tascheter Sector WZ-P a5-1	T (Brown dwarf) Star
Hazel	M (Red dwarf) Star
Hranit	M (Red dwarf) Star
Ekhi	K (Yellow-Orange) Star
Tascheter Sector YK-O a6-2	T (Brown dwarf) Star
Athra	M (Red dwarf) Star
Tascheter Sector SY-S b3-5	M (Red dwarf) Star
Tascheter Sector EG-X a1-5	Y (Brown dwarf) Star
Tascheter Sector CL-Y d121	F (White) Star
Tascheter Sector KH-V a2-2	L (Brown dwarf) Star
Wolf 1278	M (Red dwarf) Star
LHS 1290	M (Red dwarf) Star
Herishep	K (Yellow-Orange) Star
Core Sys Sector WJ-R a4-1	T Tauri Star
Apollo	M (Red dwarf) Star
Djaujang	M (Red dwarf) Star
Tascheter Sector GB-X a1-3	T Tauri Star
Yamahun	M (Red dwarf) Star
Tascheter Sector AA-Z a1	Y (Brown dwarf) Star
Wolf 25	K (Yellow-Orange) Star
NLTT 8084	M (Red dwarf) Star
Piscium Sector IR-W c1-28	K (Yellow-Orange) Star
Tascheter Sector EL-Y b5	T Tauri Star
Meri	K (Yellow-Orange) Star
LHS 1487	K (Yellow-Orange) Star
LDS 3195	K (Yellow-Orange) Star
BR Piscium	M (Red dwarf) Star
LTT 11503	M (Red dwarf) Star
V546 Persei	M (Red dwarf) Star
BD-14 249	M (Red dwarf) Star
BZ Ceti	K (Yellow-Orange) Star
LHS 5061	M (Red dwarf) Star
Tascheter Sector GB-X a1-4	T (Brown dwarf) Star
LHS 1225	K (Yellow-Orange) Star
Tascheter Sector KH-V a2-1	T Tauri Star
Tascheter Sector IM-V a2-0	L (Brown dwarf) Star
Caleta	K (Yellow-Orange) Star
Tascheter Sector ST-R a4-0	T (Brown dwarf) Star
Slink's Eye	White Dwarf (DA) Star
Tohil	M (Red dwarf) Star
Inti	A (Blue-White) Star
LHS 1228	M (Red dwarf) Star
Jastreb Sector HH-M a7-3	Y (Brown dwarf) Star
Hoff	G (White-Yellow) Star
Groombridge 34	M (Red dwarf) Star
LHS 1326	M (Red dwarf) Star
Kaffaljidhma	A (Blue-White) Star
Ross 556	M (Red dwarf) Star
Piscium Sector MC-V b2-1	M (Red dwarf) Star
Core Sys Sector QI-T a3-1	T (Brown dwarf) Star
Ross 248	M (Red dwarf) Star
LHS 1358	M (Red dwarf) Star
Piscium Sector SD-T b3-7	M (Red dwarf) Star
LHS 1375	M (Red dwarf) Star
BD+14 611	K (Yellow-Orange) Star
Tascheter Sector QY-R a4-0	T (Brown dwarf) Star
Haga	M (Red dwarf) Star
BD+02 305	M (Red dwarf) Star
Tascheter Sector UE-Q a5-2	T (Brown dwarf) Star
Piscium Sector SD-T b3-0	M (Red dwarf) Star
Tascheter Sector IR-W b1-7	M (Red dwarf) Star
Jastreb Sector JC-M a7-2	Y (Brown dwarf) Star
Jastreb Sector HH-M a7-4	T (Brown dwarf) Star
Tascheter Sector EM-M a7-1	Y (Brown dwarf) Star
LTT 1147	K (Yellow-Orange) Star
Karabal	M (Red dwarf) Star
LHS 1426	M (Red dwarf) Star
Piscium Sector EL-Y c14	K (Yellow-Orange) Star
LTT 11098	K (Yellow-Orange) Star
Tascheter Sector CV-Y a4	Y (Brown dwarf) Star
Tascheter Sector AG-O a6-1	T (Brown dwarf) Star
Al-Qaum	K (Yellow-Orange giant) Star
Maiden	M (Red dwarf) Star
LFT 142	White Dwarf (DA) Star
GCRV 52424	G (White-Yellow) Star
Oduduro	F (White) Star
Tascheter Sector CV-Y a5	T (Brown dwarf) Star
Jardovici	M (Red dwarf) Star
HR 197	F (White) Star
NLTT 8662	K (Yellow-Orange) Star
50 Omega Tauri	A (Blue-White) Star
Metzili	K (Yellow-Orange) Star
Core Sys Sector SD-T a3-1	T (Brown dwarf) Star
Core Sys Sector SD-T a3-4	T (Brown dwarf) Star
LHS 1765	M (Red dwarf) Star
Jaralland	M (Red dwarf) Star
39 Tauri	G (White-Yellow) Star
LFT 163	M (Red dwarf) Star
Wolf 124	M (Red dwarf) Star
Tascheter Sector CR-M a7-0	Y (Brown dwarf) Star
G 5-32	M (Red dwarf) Star
Tascheter Sector UE-Q a5-0	T (Brown dwarf) Star
Geras	White Dwarf (DC) Star
Ceti Sector TY-A b5	M (Red dwarf) Star
Manah	K (Yellow-Orange) Star
StKM 1-367	K (Yellow-Orange) Star
Tascheter Sector OS-U b2-1	T Tauri Star
Gautama	M (Red dwarf) Star
Tascheter Sector AG-O a6-0	T (Brown dwarf) Star
LHS 1124	K (Yellow-Orange) Star
53 chi Ceti	F (White) Star
LP 415-18	M (Red dwarf) Star
LTT 11519	M (Red dwarf) Star
NLTT 9032	M (Red dwarf) Star
Arietis Sector XE-Q b5-2	L (Brown dwarf) Star
Tascheter Sector MS-T a3-2	T (Brown dwarf) Star
LP 825-559	White Dwarf (DA) Star
van Maanen's Star	White Dwarf (D) Star
Mwamen	M (Red dwarf) Star
Fujin	G (White-Yellow) Star
Tascheter Sector UE-Q a5-1	T Tauri Star
Tascheter Sector CR-M a7-1	T (Brown dwarf) Star
LHS 2	M (Red dwarf) Star
Piscium Sector MC-V b2-2	T Tauri Star
84 Ceti	F (White) Star
LHS 178	M (Red dwarf) Star
Ceti Sector WO-A c25	K (Yellow-Orange) Star
Tascheter Sector AA-Z a6	T (Brown dwarf) Star
Wuluwait	K (Yellow-Orange) Star
LHS 1504	M (Red dwarf) Star
TZ Arietis	M (Red dwarf) Star
LTT 11103	K (Yellow-Orange) Star
Tascheter Sector FW-W c1-29	K (Yellow-Orange) Star
G 85-12	M (Red dwarf) Star
Farowalan	M (Red dwarf) Star
Tascheter Sector FL-Y b2	M (Red dwarf) Star
LHS 1302	M (Red dwarf) Star
Tascheter Sector BQ-Y c19	G (White-Yellow) Star
Tascheter Sector JS-K a8-0	L (Brown dwarf) Star
Tascheter Sector ZK-O a6-0	T (Brown dwarf) Star
Core Sys Sector TD-T a3-1	Y (Brown dwarf) Star
Tascheter Sector RY-R a4-1	T (Brown dwarf) Star
Apan	M (Red dwarf) Star
Piscium Sector NC-V b2-3	T Tauri Star
Tascheter Sector BG-O a6-1	T Tauri Star
FT Ceti	K (Yellow-Orange) Star
Tascheter Sector BA-Z a2	T (Brown dwarf) Star
Tascheter Sector RY-R a4-2	T (Brown dwarf) Star
PSPF-LF 2	K (Yellow-Orange) Star
Ross 555	M (Red dwarf) Star
Jastreb Sector IH-M a7-0	L (Brown dwarf) Star
HERZ 10688	K (Yellow-Orange) Star
Saranyu	M (Red dwarf) Star
LTT 11244	K (Yellow-Orange) Star
BD+11 514	K (Yellow-Orange) Star
Arietis Sector AA-Q b5-0	M (Red dwarf) Star
Tascheter Sector XZ-P a5-0	T (Brown dwarf) Star
Tascheter Sector NS-T a3-3	T (Brown dwarf) Star
Core Sys Sector TD-T a3-0	T (Brown dwarf) Star
Tascheter Sector ZK-O a6-1	T (Brown dwarf) Star
Tascheter Sector VE-Q a5-0	Y (Brown dwarf) Star
Wayaliti	T (Brown dwarf) Star
G 268-47	M (Red dwarf) Star
Core Sys Sector XJ-R a4-1	Y (Brown dwarf) Star
Ursitoare	G (White-Yellow) Star
Tascheter Sector CL-Y d115	L (Brown dwarf) Star
Tascheter Sector NS-T a3-1	L (Brown dwarf) Star
Tascheter Sector RY-R a4-3	Y (Brown dwarf) Star
Teegarden's Star	M (Red dwarf) Star
LP 415-26	M (Red dwarf) Star
LHS 1610	M (Red dwarf) Star
LHS 134	M (Red dwarf) Star
Onyaksas	M (Red dwarf) Star
Tascheter Sector DR-M a7-0	T Tauri Star
Blanquichu	M (Red dwarf) Star
StKM 1-383	K (Yellow-Orange) Star
Shangdi	K (Yellow-Orange) Star
Tascheter Sector BG-O a6-0	T (Brown dwarf) Star
Tascheter Sector NS-T a3-0	Y (Brown dwarf) Star
Tascheter Sector HX-K a8-1	Y (Brown dwarf) Star
LFT 65	White Dwarf (DQ) Star
Tascheter Sector NS-T a3-2	T (Brown dwarf) Star
LHS 1442	White Dwarf (DA) Star
Lowne 1	G (White-Yellow) Star
Tascheter Sector HX-K a8-0	T (Brown dwarf) Star
Core Sys Sector TD-T a3-2	Y (Brown dwarf) Star
Piscium Sector PX-U b2-0	M (Red dwarf) Star
Hai Ho	T (Brown dwarf) Star
Tascheter Sector FM-M a7-2	Y (Brown dwarf) Star
Tascheter Sector JM-V a2-1	L (Brown dwarf) Star
BD+21 652	M (Red dwarf) Star
LHS 1681	M (Red dwarf) Star
Tascheter Sector RY-R a4-0	Y (Brown dwarf) Star
Uzumoxii	T Tauri Star
Tascheter Sector NS-T a3-5	T (Brown dwarf) Star
Piscium Sector NC-V b2-2	M (Red dwarf) Star
Lokipi	M (Red dwarf) Star
Jastreb Sector IH-M a7-1	T (Brown dwarf) Star
WISE J0254+0223	T (Brown dwarf) Star
Set	L (Brown dwarf) Star
Ceti Sector WJ-Z b0	M (Red dwarf) Star
G 85-36	M (Red dwarf) Star
Atagat	M (Red dwarf) Star
Tascheter Sector FG-X a1-2	T (Brown dwarf) Star
Akkadia	K (Yellow-Orange) Star
Tascheter Sector FM-M a7-0	T (Brown dwarf) Star
CD Ceti	M (Red dwarf) Star
Padhyas	F (White) Star
LP 532-81	M (Red dwarf) Star
Tascheter Sector BV-Y b4	M (Red dwarf) Star
BD+21 717	K (Yellow-Orange) Star
YZ Ceti	M (Red dwarf) Star
Tascheter Sector FM-M a7-1	Y (Brown dwarf) Star
LHS 1706	M (Red dwarf) Star
Erne	K (Yellow-Orange) Star
Tascheter Sector JM-V a2-2	L (Brown dwarf) Star
Ceti Sector GR-V b2-1	M (Red dwarf) Star
Tascheter Sector PN-T a3-1	T (Brown dwarf) Star
Tascheter Sector FB-X b1-4	M (Red dwarf) Star
Core Sys Sector TD-T a3-3	T (Brown dwarf) Star
Alaunus	M (Red dwarf) Star
V484 Tauri	M (Red dwarf) Star
Tascheter Sector FM-M a7-3	Y (Brown dwarf) Star
Core Sys Sector VO-R a4-1	T (Brown dwarf) Star
LHS 17	M (Red dwarf) Star
LHS 1540	M (Red dwarf) Star
LP 415-1446	M (Red dwarf) Star
LHS 1593	M (Red dwarf) Star
Kappa-1 Ceti	G (White-Yellow) Star
WISE 0410+1502	Y (Brown dwarf) Star
Tau Ceti	G (White-Yellow) Star
Tascheter Sector DV-Y a0	Y (Brown dwarf) Star
UV Ceti	M (Red dwarf) Star
Circe	G (White-Yellow) Star
Marajoara	L (Brown dwarf) Star
Sol	G (White-Yellow) Star
